ID,Флаг дозвона,Флаг продажи,Расходы,PV,NPV
0,1,1,337,1295,958
1,1,1,740,1578,838
2,0,0,32,0,-32
3,1,1,269,1279,1010
4,1,1,298,1381,1083
5,1,1,3846,1840,-2006
6,1,0,91,0,-91
7,0,0,8,0,-8
8,1,0,9,0,-9
9,0,0,133,0,-133
10,1,1,335,1274,939
11,0,0,62,0,-62
12,1,0,104,0,-104
13,1,1,422,1511,1089
14,1,1,252,1975,1723
15,1,1,899,1247,348
16,1,1,1481,1324,-157
17,1,1,366,1638,1272
18,0,0,1,0,-1
19,0,0,65,0,-65
20,1,0,53,0,-53
21,0,0,18,0,-18
22,0,0,103,0,-103
23,1,1,1076,2160,1084
24,1,0,52,0,-52
25,1,1,594,1638,1044
26,0,0,40,0,-40
27,0,0,117,0,-117
28,1,1,873,1954,1081
29,0,0,34,0,-34
30,1,0,17,0,-17
31,1,1,509,1275,766
32,0,0,26,0,-26
33,1,1,1088,1657,569
34,1,0,105,0,-105
35,1,1,206,2828,2622
36,1,0,0,0,0
37,1,0,18,0,-18
38,1,1,306,2558,2252
39,0,0,120,0,-120
40,1,0,31,0,-31
41,1,1,267,3022,2755
42,0,0,4,0,-4
43,1,1,17,1300,1283
44,1,1,69,1242,1173
45,1,1,919,1259,340
46,0,0,24,0,-24
47,1,1,440,1311,871
48,0,0,50,0,-50
49,1,1,510,1342,832
50,0,0,45,0,-45
51,0,0,75,0,-75
52,1,1,301,1398,1097
53,0,0,45,0,-45
54,1,0,91,0,-91
55,1,1,72,1549,1477
56,0,0,95,0,-95
57,1,0,0,0,0
58,1,1,575,1477,902
59,1,1,394,1359,965
60,0,0,36,0,-36
61,1,0,45,0,-45
62,1,1,1457,1249,-208
63,1,0,92,0,-92
64,1,0,82,0,-82
65,0,0,2,0,-2
66,0,0,21,0,-21
67,1,1,438,1509,1071
68,1,1,150,1707,1557
69,1,0,17,0,-17
70,1,0,88,0,-88
71,1,1,141,1638,1497
72,1,0,25,0,-25
73,0,0,5,0,-5
74,0,0,3,0,-3
75,0,0,85,0,-85
76,1,1,1355,1260,-95
77,1,0,30,0,-30
78,0,0,51,0,-51
79,1,0,55,0,-55
80,1,1,1028,1326,298
81,1,0,0,0,0
82,0,0,11,0,-11
83,0,0,8,0,-8
84,0,0,35,0,-35
85,1,1,176,1490,1314
86,0,0,51,0,-51
87,1,0,14,0,-14
88,1,0,28,0,-28
89,0,0,44,0,-44
90,1,0,38,0,-38
91,1,1,642,1378,736
92,1,0,105,0,-105
93,1,1,322,1681,1359
94,1,1,1136,1954,818
95,1,0,56,0,-56
96,1,1,1928,1308,-620
97,1,1,1990,1760,-230
98,1,1,153,1332,1179
99,1,1,236,1260,1024
100,1,1,163,1360,1197
101,0,0,3,0,-3
102,1,1,427,1510,1083
103,0,0,215,0,-215
104,0,0,31,0,-31
105,0,0,51,0,-51
106,0,0,78,0,-78
107,0,0,7,0,-7
108,1,1,873,1406,533
109,1,1,1486,1515,29
110,1,1,318,1353,1035
111,1,0,27,0,-27
112,0,0,55,0,-55
113,1,0,12,0,-12
114,1,0,3,0,-3
115,1,0,1,0,-1
116,0,0,49,0,-49
117,1,1,223,1605,1382
118,0,0,17,0,-17
119,1,1,250,2689,2439
120,0,0,127,0,-127
121,1,1,43,1670,1627
122,0,0,41,0,-41
123,1,0,125,0,-125
124,0,0,14,0,-14
125,1,1,93,1388,1295
126,0,0,4,0,-4
127,1,0,44,0,-44
128,1,1,301,1500,1199
129,0,0,9,0,-9
130,0,0,47,0,-47
131,1,0,21,0,-21
132,1,1,826,1523,697
133,0,0,3,0,-3
134,0,0,155,0,-155
135,1,1,1165,1293,128
136,0,0,16,0,-16
137,1,1,434,1324,890
138,0,0,34,0,-34
139,0,0,14,0,-14
140,0,0,8,0,-8
141,0,0,17,0,-17
142,0,0,78,0,-78
143,1,1,63,1351,1288
144,0,0,49,0,-49
145,1,1,246,1298,1052
146,1,0,19,0,-19
147,0,0,130,0,-130
148,1,0,96,0,-96
149,0,0,95,0,-95
150,0,0,10,0,-10
151,1,0,123,0,-123
152,0,0,67,0,-67
153,1,0,50,0,-50
154,0,0,24,0,-24
155,1,0,104,0,-104
156,0,0,123,0,-123
157,1,0,55,0,-55
158,1,1,104,1536,1432
159,0,0,31,0,-31
160,0,0,30,0,-30
161,1,0,144,0,-144
162,1,1,379,1450,1071
163,1,0,42,0,-42
164,0,0,6,0,-6
165,0,0,72,0,-72
166,1,0,6,0,-6
167,0,0,32,0,-32
168,0,0,138,0,-138
169,1,1,394,1309,915
170,1,1,56,2009,1953
171,0,0,14,0,-14
172,1,0,47,0,-47
173,1,0,5,0,-5
174,1,1,177,1323,1146
175,1,0,140,0,-140
176,0,0,34,0,-34
177,1,0,307,0,-307
178,1,0,0,0,0
179,1,1,445,1279,834
180,0,0,74,0,-74
181,0,0,46,0,-46
182,1,1,99,1326,1227
183,1,0,86,0,-86
184,0,0,19,0,-19
185,0,0,251,0,-251
186,1,0,125,0,-125
187,0,0,196,0,-196
188,0,0,4,0,-4
189,1,0,84,0,-84
190,0,0,84,0,-84
191,1,1,3563,1241,-2322
192,1,1,283,1403,1120
193,1,0,37,0,-37
194,1,1,21,1525,1504
195,0,0,43,0,-43
196,0,0,10,0,-10
197,1,0,50,0,-50
198,1,1,262,1261,999
199,0,0,2,0,-2
200,1,1,114,1336,1222
201,0,0,5,0,-5
202,0,0,49,0,-49
203,1,0,29,0,-29
204,0,0,16,0,-16
205,1,1,412,1291,879
206,1,0,15,0,-15
207,1,0,54,0,-54
208,1,1,35,1531,1496
209,1,1,559,1975,1416
210,0,0,29,0,-29
211,0,0,13,0,-13
212,0,0,62,0,-62
213,1,0,9,0,-9
214,1,1,150,1573,1423
215,1,0,24,0,-24
216,1,0,96,0,-96
217,0,0,103,0,-103
218,1,1,110,1495,1385
219,0,0,111,0,-111
220,1,1,116,1463,1347
221,1,1,333,3288,2955
222,0,0,56,0,-56
223,0,0,182,0,-182
224,1,0,7,0,-7
225,0,0,12,0,-12
226,1,0,1,0,-1
227,1,0,23,0,-23
228,1,1,1187,1496,309
229,1,0,39,0,-39
230,0,0,6,0,-6
231,0,0,77,0,-77
232,1,1,755,1468,713
233,0,0,39,0,-39
234,1,1,239,1831,1592
235,1,1,271,1399,1128
236,0,0,36,0,-36
237,1,0,24,0,-24
238,1,1,571,2985,2414
239,0,0,46,0,-46
240,1,1,75,1286,1211
241,1,1,212,1369,1157
242,0,0,15,0,-15
243,0,0,115,0,-115
244,1,1,1350,1760,410
245,1,1,686,1553,867
246,1,0,9,0,-9
247,1,1,249,1344,1095
248,1,1,305,2323,2018
249,1,0,45,0,-45
250,1,1,862,1298,436
251,1,1,1183,1318,135
252,1,0,167,0,-167
253,0,0,4,0,-4
254,1,1,565,1305,740
255,1,0,6,0,-6
256,1,0,98,0,-98
257,1,0,107,0,-107
258,0,0,154,0,-154
259,1,0,74,0,-74
260,0,0,281,0,-281
261,1,1,327,1516,1189
262,1,0,12,0,-12
263,1,0,59,0,-59
264,1,1,193,1520,1327
265,0,0,19,0,-19
266,0,0,45,0,-45
267,1,1,603,1518,915
268,0,0,81,0,-81
269,1,0,0,0,0
270,1,1,520,1391,871
271,1,1,1646,1299,-347
272,1,1,182,1328,1146
273,0,0,12,0,-12
274,1,1,132,1674,1542
275,1,0,23,0,-23
276,0,0,38,0,-38
277,1,0,4,0,-4
278,1,1,532,1273,741
279,0,0,12,0,-12
280,0,0,210,0,-210
281,1,1,464,2091,1627
282,1,0,20,0,-20
283,0,0,7,0,-7
284,0,0,7,0,-7
285,1,0,42,0,-42
286,1,1,127,1393,1266
287,1,0,1,0,-1
288,1,1,465,1508,1043
289,1,0,23,0,-23
290,1,1,1478,1409,-69
291,1,0,6,0,-6
292,1,0,6,0,-6
293,1,0,18,0,-18
294,0,0,34,0,-34
295,0,0,51,0,-51
296,1,1,1695,1944,249
297,0,0,104,0,-104
298,1,0,33,0,-33
299,1,0,30,0,-30
300,0,0,56,0,-56
301,1,1,12,1254,1242
302,1,0,29,0,-29
303,0,0,18,0,-18
304,1,1,834,1253,419
305,1,1,533,1847,1314
306,0,0,198,0,-198
307,1,1,917,1313,396
308,0,0,72,0,-72
309,0,0,78,0,-78
310,1,0,6,0,-6
311,0,0,13,0,-13
312,0,0,50,0,-50
313,1,1,2361,1286,-1075
314,0,0,12,0,-12
315,0,0,35,0,-35
316,0,0,4,0,-4
317,1,1,1071,8114,7043
318,1,0,3,0,-3
319,1,1,2545,2217,-328
320,1,1,95,1629,1534
321,0,0,32,0,-32
322,1,0,26,0,-26
323,0,0,59,0,-59
324,1,0,7,0,-7
325,0,0,18,0,-18
326,1,0,53,0,-53
327,1,1,154,2342,2188
328,0,0,32,0,-32
329,0,0,32,0,-32
330,1,1,535,1848,1313
331,0,0,49,0,-49
332,1,1,296,1882,1586
333,1,1,37,2434,2397
334,1,0,20,0,-20
335,0,0,29,0,-29
336,1,0,45,0,-45
337,1,1,343,1322,979
338,1,1,313,1319,1006
339,1,0,54,0,-54
340,0,0,13,0,-13
341,0,0,35,0,-35
342,1,0,15,0,-15
343,1,1,237,1325,1088
344,1,1,752,1397,645
345,1,0,12,0,-12
346,0,0,29,0,-29
347,1,0,4,0,-4
348,1,1,39,2101,2062
349,1,0,28,0,-28
350,1,1,139,1415,1276
351,1,0,91,0,-91
352,1,1,443,2510,2067
353,1,0,62,0,-62
354,1,1,200,1737,1537
355,1,1,152,1481,1329
356,0,0,9,0,-9
357,1,1,188,2666,2478
358,1,1,266,1547,1281
359,1,0,34,0,-34
360,0,0,137,0,-137
361,1,1,1168,1381,213
362,1,1,128,2803,2675
363,1,0,8,0,-8
364,0,0,7,0,-7
365,0,0,27,0,-27
366,0,0,48,0,-48
367,0,0,12,0,-12
368,0,0,11,0,-11
369,1,0,87,0,-87
370,0,0,36,0,-36
371,0,0,20,0,-20
372,1,1,47,1430,1383
373,0,0,74,0,-74
374,1,1,91,1558,1467
375,0,0,40,0,-40
376,0,0,16,0,-16
377,1,1,237,1656,1419
378,0,0,44,0,-44
379,0,0,42,0,-42
380,1,1,711,1493,782
381,0,0,28,0,-28
382,1,0,167,0,-167
383,1,1,320,1951,1631
384,0,0,72,0,-72
385,0,0,16,0,-16
386,0,0,11,0,-11
387,0,0,19,0,-19
388,1,0,186,0,-186
389,1,0,59,0,-59
390,0,0,70,0,-70
391,1,1,215,1366,1151
392,1,0,20,0,-20
393,1,1,416,2294,1878
394,1,1,1684,1387,-297
395,0,0,11,0,-11
396,0,0,47,0,-47
397,0,0,63,0,-63
398,1,0,62,0,-62
399,0,0,30,0,-30
400,1,1,390,1394,1004
401,1,1,156,1728,1572
402,1,1,88,1425,1337
403,0,0,3,0,-3
404,1,0,45,0,-45
405,0,0,12,0,-12
406,1,1,54,1244,1190
407,1,1,684,1239,555
408,0,0,131,0,-131
409,0,0,24,0,-24
410,1,1,93,1287,1194
411,1,0,200,0,-200
412,0,0,38,0,-38
413,1,1,543,1543,1000
414,1,0,21,0,-21
415,1,0,41,0,-41
416,0,0,73,0,-73
417,1,1,299,1894,1595
418,1,1,50,1931,1881
419,0,0,33,0,-33
420,1,1,214,1495,1281
421,1,1,834,1352,518
422,0,0,83,0,-83
423,1,0,61,0,-61
424,0,0,14,0,-14
425,0,0,78,0,-78
426,0,0,90,0,-90
427,1,1,609,1452,843
428,0,0,29,0,-29
429,1,1,228,2073,1845
430,1,1,840,1268,428
431,0,0,65,0,-65
432,1,1,108,1906,1798
433,1,0,95,0,-95
434,0,0,58,0,-58
435,1,0,40,0,-40
436,1,1,225,1717,1492
437,0,0,4,0,-4
438,1,0,39,0,-39
439,1,0,38,0,-38
440,1,0,19,0,-19
441,1,1,285,2499,2214
442,1,0,104,0,-104
443,0,0,1,0,-1
444,0,0,132,0,-132
445,0,0,65,0,-65
446,0,0,45,0,-45
447,1,1,244,1379,1135
448,1,1,132,1624,1492
449,1,0,108,0,-108
450,1,0,68,0,-68
451,1,1,524,1533,1009
452,0,0,96,0,-96
453,1,1,166,1330,1164
454,1,1,618,1317,699
455,0,0,11,0,-11
456,0,0,41,0,-41
457,1,0,38,0,-38
458,1,0,33,0,-33
459,0,0,10,0,-10
460,1,0,48,0,-48
461,1,0,137,0,-137
462,1,0,81,0,-81
463,1,0,57,0,-57
464,0,0,71,0,-71
465,1,1,33,3833,3800
466,1,0,52,0,-52
467,0,0,41,0,-41
468,0,0,30,0,-30
469,0,0,10,0,-10
470,1,1,724,1573,849
471,1,1,155,2465,2310
472,1,1,736,1256,520
473,1,1,185,1373,1188
474,1,0,4,0,-4
475,0,0,90,0,-90
476,1,0,111,0,-111
477,0,0,145,0,-145
478,0,0,19,0,-19
479,0,0,74,0,-74
480,0,0,89,0,-89
481,1,0,24,0,-24
482,0,0,87,0,-87
483,1,0,20,0,-20
484,1,0,51,0,-51
485,0,0,2,0,-2
486,1,0,10,0,-10
487,0,0,0,0,0
488,0,0,134,0,-134
489,1,0,36,0,-36
490,1,1,340,1237,897
491,1,0,190,0,-190
492,1,0,71,0,-71
493,1,1,515,1263,748
494,1,0,14,0,-14
495,1,0,72,0,-72
496,0,0,76,0,-76
497,1,1,53,1290,1237
498,0,0,6,0,-6
499,1,0,62,0,-62
500,0,0,62,0,-62
501,0,0,142,0,-142
502,0,0,25,0,-25
503,0,0,5,0,-5
504,0,0,25,0,-25
505,1,0,79,0,-79
506,0,0,1,0,-1
507,1,1,216,1309,1093
508,0,0,34,0,-34
509,1,0,33,0,-33
510,0,0,182,0,-182
511,0,0,54,0,-54
512,1,0,30,0,-30
513,1,0,14,0,-14
514,0,0,65,0,-65
515,1,1,960,5798,4838
516,0,0,96,0,-96
517,1,1,1810,1497,-313
518,0,0,0,0,0
519,0,0,67,0,-67
520,0,0,112,0,-112
521,0,0,192,0,-192
522,1,0,48,0,-48
523,0,0,37,0,-37
524,1,1,359,1346,987
525,0,0,6,0,-6
526,0,0,7,0,-7
527,1,1,1087,2023,936
528,1,0,8,0,-8
529,1,0,40,0,-40
530,1,1,1179,1924,745
531,1,0,62,0,-62
532,1,0,32,0,-32
533,1,1,41,1305,1264
534,1,0,10,0,-10
535,0,0,97,0,-97
536,0,0,64,0,-64
537,1,1,202,1986,1784
538,1,0,42,0,-42
539,0,0,22,0,-22
540,0,0,132,0,-132
541,1,0,81,0,-81
542,0,0,44,0,-44
543,0,0,34,0,-34
544,1,0,14,0,-14
545,1,1,1187,1265,78
546,1,1,123,1428,1305
547,1,0,53,0,-53
548,1,0,39,0,-39
549,0,0,16,0,-16
550,0,0,4,0,-4
551,1,1,436,1276,840
552,0,0,87,0,-87
553,1,1,552,1283,731
554,1,1,558,1326,768
555,1,1,91,2198,2107
556,1,0,21,0,-21
557,0,0,14,0,-14
558,0,0,25,0,-25
559,1,1,330,1471,1141
560,1,1,471,1431,960
561,0,0,84,0,-84
562,1,1,419,1433,1014
563,1,1,847,2130,1283
564,0,0,340,0,-340
565,0,0,47,0,-47
566,1,0,1,0,-1
567,1,0,28,0,-28
568,1,0,59,0,-59
569,1,1,250,1441,1191
570,0,0,124,0,-124
571,1,1,772,1297,525
572,0,0,76,0,-76
573,1,1,1207,1296,89
574,0,0,20,0,-20
575,0,0,80,0,-80
576,0,0,123,0,-123
577,0,0,2,0,-2
578,1,1,25,1552,1527
579,0,0,10,0,-10
580,1,1,854,1440,586
581,0,0,42,0,-42
582,1,1,124,1526,1402
583,1,0,19,0,-19
584,1,0,17,0,-17
585,0,0,2,0,-2
586,1,1,354,4263,3909
587,0,0,6,0,-6
588,1,1,9,2334,2325
589,0,0,83,0,-83
590,0,0,27,0,-27
591,0,0,28,0,-28
592,0,0,58,0,-58
593,1,1,356,1571,1215
594,1,1,319,1298,979
595,0,0,7,0,-7
596,0,0,206,0,-206
597,0,0,17,0,-17
598,1,1,436,1845,1409
599,0,0,5,0,-5
600,1,0,47,0,-47
601,0,0,196,0,-196
602,0,0,1,0,-1
603,1,0,1,0,-1
604,0,0,18,0,-18
605,1,0,108,0,-108
606,1,0,55,0,-55
607,1,0,81,0,-81
608,1,1,142,1402,1260
609,1,1,512,1235,723
610,1,1,171,1793,1622
611,0,0,0,0,0
612,0,0,33,0,-33
613,1,0,51,0,-51
614,1,0,44,0,-44
615,1,1,400,1386,986
616,0,0,13,0,-13
617,1,0,92,0,-92
618,1,0,91,0,-91
619,1,1,748,1426,678
620,1,1,426,1256,830
621,1,1,233,1345,1112
622,1,1,478,1981,1503
623,0,0,39,0,-39
624,1,0,87,0,-87
625,1,0,48,0,-48
626,1,0,68,0,-68
627,0,0,9,0,-9
628,1,1,228,1410,1182
629,0,0,113,0,-113
630,1,1,585,1392,807
631,1,1,536,2763,2227
632,0,0,83,0,-83
633,0,0,107,0,-107
634,1,1,306,1820,1514
635,0,0,31,0,-31
636,0,0,20,0,-20
637,1,0,38,0,-38
638,0,0,65,0,-65
639,1,0,32,0,-32
640,1,0,64,0,-64
641,0,0,12,0,-12
642,0,0,45,0,-45
643,1,0,0,0,0
644,0,0,16,0,-16
645,1,0,136,0,-136
646,1,0,40,0,-40
647,1,0,27,0,-27
648,0,0,76,0,-76
649,0,0,10,0,-10
650,1,0,74,0,-74
651,0,0,139,0,-139
652,0,0,38,0,-38
653,1,1,591,1430,839
654,1,1,523,1420,897
655,1,1,363,1267,904
656,1,1,2222,1815,-407
657,0,0,44,0,-44
658,0,0,8,0,-8
659,1,1,52,1843,1791
660,1,1,963,1279,316
661,1,1,1307,2118,811
662,1,0,51,0,-51
663,1,1,1110,1326,216
664,0,0,76,0,-76
665,1,0,101,0,-101
666,0,0,56,0,-56
667,1,0,2,0,-2
668,1,1,980,1367,387
669,1,0,56,0,-56
670,0,0,157,0,-157
671,0,0,17,0,-17
672,1,1,593,1408,815
673,0,0,129,0,-129
674,1,0,7,0,-7
675,1,0,74,0,-74
676,0,0,128,0,-128
677,1,0,4,0,-4
678,0,0,3,0,-3
679,0,0,16,0,-16
680,0,0,14,0,-14
681,0,0,43,0,-43
682,1,0,32,0,-32
683,1,0,107,0,-107
684,1,1,920,1299,379
685,1,1,129,1518,1389
686,1,1,58,1412,1354
687,0,0,54,0,-54
688,1,1,424,1277,853
689,0,0,2,0,-2
690,0,0,21,0,-21
691,1,1,150,1242,1092
692,0,0,1,0,-1
693,0,0,45,0,-45
694,0,0,154,0,-154
695,1,0,46,0,-46
696,1,1,1922,1405,-517
697,1,1,374,1578,1204
698,1,0,204,0,-204
699,1,1,243,1520,1277
700,0,0,89,0,-89
701,1,1,244,1625,1381
702,0,0,10,0,-10
703,0,0,103,0,-103
704,0,0,15,0,-15
705,0,0,20,0,-20
706,0,0,33,0,-33
707,0,0,78,0,-78
708,1,0,65,0,-65
709,1,1,28,1918,1890
710,1,0,9,0,-9
711,0,0,70,0,-70
712,0,0,30,0,-30
713,0,0,34,0,-34
714,1,1,248,1282,1034
715,0,0,12,0,-12
716,0,0,125,0,-125
717,1,0,7,0,-7
718,1,1,1172,1363,191
719,1,1,381,4483,4102
720,0,0,108,0,-108
721,0,0,1,0,-1
722,1,1,751,1468,717
723,0,0,29,0,-29
724,1,1,255,1431,1176
725,0,0,85,0,-85
726,0,0,33,0,-33
727,0,0,119,0,-119
728,1,1,411,1246,835
729,0,0,2,0,-2
730,0,0,49,0,-49
731,0,0,63,0,-63
732,1,0,71,0,-71
733,0,0,36,0,-36
734,1,1,691,1370,679
735,1,0,7,0,-7
736,1,1,533,1554,1021
737,0,0,5,0,-5
738,1,0,106,0,-106
739,0,0,70,0,-70
740,1,1,15,1269,1254
741,0,0,139,0,-139
742,1,0,10,0,-10
743,1,1,190,1356,1166
744,1,1,1157,1307,150
745,1,1,152,1704,1552
746,1,0,63,0,-63
747,0,0,57,0,-57
748,0,0,32,0,-32
749,1,0,147,0,-147
750,1,1,1555,1379,-176
751,0,0,4,0,-4
752,0,0,28,0,-28
753,1,1,880,1649,769
754,1,0,16,0,-16
755,1,0,50,0,-50
756,1,1,225,1637,1412
757,1,0,121,0,-121
758,1,1,118,1466,1348
759,0,0,106,0,-106
760,0,0,75,0,-75
761,0,0,92,0,-92
762,0,0,143,0,-143
763,0,0,43,0,-43
764,1,0,62,0,-62
765,0,0,47,0,-47
766,0,0,65,0,-65
767,0,0,79,0,-79
768,0,0,106,0,-106
769,1,1,177,1380,1203
770,0,0,78,0,-78
771,0,0,4,0,-4
772,1,0,156,0,-156
773,1,1,1218,1599,381
774,1,0,88,0,-88
775,1,0,0,0,0
776,0,0,16,0,-16
777,1,0,39,0,-39
778,1,0,27,0,-27
779,1,1,411,1330,919
780,0,0,5,0,-5
781,0,0,221,0,-221
782,1,1,2017,1693,-324
783,1,0,70,0,-70
784,1,0,52,0,-52
785,1,1,513,1888,1375
786,0,0,46,0,-46
787,1,1,484,2347,1863
788,0,0,105,0,-105
789,1,0,8,0,-8
790,1,1,990,1235,245
791,1,0,81,0,-81
792,0,0,21,0,-21
793,1,1,1251,1240,-11
794,0,0,43,0,-43
795,1,1,55,1438,1383
796,0,0,14,0,-14
797,1,1,256,1307,1051
798,0,0,28,0,-28
799,1,1,1011,2062,1051
800,0,0,19,0,-19
801,1,1,422,1295,873
802,1,0,18,0,-18
803,1,1,217,1606,1389
804,0,0,67,0,-67
805,1,1,1260,1311,51
806,1,0,56,0,-56
807,1,1,82,1283,1201
808,1,1,675,1749,1074
809,1,0,16,0,-16
810,0,0,28,0,-28
811,1,1,1295,1294,-1
812,1,0,73,0,-73
813,1,0,29,0,-29
814,1,1,326,1461,1135
815,1,1,80,2839,2759
816,1,1,371,1696,1325
817,0,0,59,0,-59
818,1,1,290,1359,1069
819,0,0,38,0,-38
820,1,0,79,0,-79
821,1,0,12,0,-12
822,1,0,6,0,-6
823,1,1,350,1284,934
824,0,0,116,0,-116
825,0,0,101,0,-101
826,1,0,119,0,-119
827,1,1,580,1240,660
828,1,0,22,0,-22
829,0,0,33,0,-33
830,1,1,223,1548,1325
831,1,1,61,1348,1287
832,1,0,6,0,-6
833,0,0,135,0,-135
834,0,0,136,0,-136
835,1,1,318,1444,1126
836,1,1,980,1380,400
837,1,0,12,0,-12
838,1,1,569,1604,1035
839,1,1,756,1308,552
840,1,0,10,0,-10
841,0,0,6,0,-6
842,1,0,149,0,-149
843,1,1,429,1872,1443
844,0,0,27,0,-27
845,0,0,26,0,-26
846,1,1,1128,1291,163
847,1,1,2024,1592,-432
848,0,0,7,0,-7
849,1,0,187,0,-187
850,1,1,132,1346,1214
851,1,0,58,0,-58
852,0,0,36,0,-36
853,1,1,761,1303,542
854,1,1,71,1405,1334
855,1,1,2225,2138,-87
856,1,0,92,0,-92
857,0,0,73,0,-73
858,1,0,43,0,-43
859,0,0,26,0,-26
860,1,0,44,0,-44
861,0,0,0,0,0
862,1,1,151,2305,2154
863,1,0,47,0,-47
864,0,0,62,0,-62
865,1,1,2475,1470,-1005
866,0,0,60,0,-60
867,1,0,64,0,-64
868,1,0,9,0,-9
869,0,0,26,0,-26
870,1,0,1,0,-1
871,1,0,88,0,-88
872,1,1,247,1262,1015
873,0,0,29,0,-29
874,0,0,49,0,-49
875,1,1,429,1247,818
876,0,0,31,0,-31
877,1,1,1128,1452,324
878,1,1,571,2387,1816
879,1,1,310,1515,1205
880,0,0,1,0,-1
881,0,0,7,0,-7
882,0,0,31,0,-31
883,1,0,139,0,-139
884,0,0,51,0,-51
885,1,0,6,0,-6
886,1,0,110,0,-110
887,1,0,9,0,-9
888,0,0,33,0,-33
889,1,0,192,0,-192
890,0,0,8,0,-8
891,1,0,125,0,-125
892,0,0,116,0,-116
893,1,1,105,1843,1738
894,0,0,38,0,-38
895,1,1,299,1371,1072
896,0,0,220,0,-220
897,1,1,705,1570,865
898,1,0,47,0,-47
899,1,1,92,2568,2476
900,1,0,8,0,-8
901,0,0,137,0,-137
902,0,0,59,0,-59
903,0,0,8,0,-8
904,1,0,114,0,-114
905,0,0,149,0,-149
906,1,0,38,0,-38
907,1,0,9,0,-9
908,0,0,23,0,-23
909,1,0,5,0,-5
910,0,0,38,0,-38
911,0,0,22,0,-22
912,1,0,114,0,-114
913,1,1,489,3224,2735
914,1,1,2182,1387,-795
915,1,1,277,1394,1117
916,0,0,33,0,-33
917,1,0,12,0,-12
918,0,0,29,0,-29
919,1,1,1434,1840,406
920,1,0,43,0,-43
921,1,0,45,0,-45
922,1,1,22,1519,1497
923,1,0,3,0,-3
924,0,0,30,0,-30
925,0,0,50,0,-50
926,0,0,25,0,-25
927,1,1,1049,1858,809
928,1,1,263,1307,1044
929,0,0,38,0,-38
930,1,0,49,0,-49
931,0,0,162,0,-162
932,1,0,34,0,-34
933,1,1,1464,1525,61
934,0,0,24,0,-24
935,0,0,107,0,-107
936,1,0,105,0,-105
937,1,1,679,1943,1264
938,0,0,15,0,-15
939,1,0,2,0,-2
940,0,0,171,0,-171
941,1,0,1,0,-1
942,0,0,56,0,-56
943,0,0,159,0,-159
944,0,0,6,0,-6
945,1,0,24,0,-24
946,0,0,112,0,-112
947,1,1,68,1320,1252
948,0,0,4,0,-4
949,1,0,2,0,-2
950,1,0,13,0,-13
951,1,0,31,0,-31
952,0,0,55,0,-55
953,0,0,13,0,-13
954,1,1,237,2188,1951
955,1,1,65,2287,2222
956,0,0,36,0,-36
957,1,0,29,0,-29
958,0,0,16,0,-16
959,1,1,303,1948,1645
960,0,0,48,0,-48
961,0,0,36,0,-36
962,0,0,33,0,-33
963,1,1,827,2131,1304
964,0,0,4,0,-4
965,1,1,321,1367,1046
966,1,0,43,0,-43
967,1,0,119,0,-119
968,1,0,256,0,-256
969,0,0,4,0,-4
970,0,0,14,0,-14
971,0,0,196,0,-196
972,1,1,874,1328,454
973,0,0,13,0,-13
974,1,0,46,0,-46
975,0,0,11,0,-11
976,1,0,10,0,-10
977,1,1,454,1244,790
978,0,0,39,0,-39
979,1,1,221,1335,1114
980,0,0,158,0,-158
981,1,1,523,1366,843
982,1,0,36,0,-36
983,1,0,23,0,-23
984,1,0,111,0,-111
985,1,0,57,0,-57
986,1,1,467,2506,2039
987,1,1,1069,1307,238
988,0,0,14,0,-14
989,1,1,153,1282,1129
990,0,0,8,0,-8
991,1,1,1235,1313,78
992,0,0,144,0,-144
993,0,0,47,0,-47
994,1,0,37,0,-37
995,0,0,70,0,-70
996,1,0,126,0,-126
997,0,0,29,0,-29
998,0,0,71,0,-71
999,1,1,463,1521,1058
1000,1,0,11,0,-11
1001,1,0,30,0,-30
1002,1,1,147,1286,1139
1003,1,1,834,1390,556
1004,1,1,131,1403,1272
1005,0,0,3,0,-3
1006,1,1,111,1498,1387
1007,0,0,26,0,-26
1008,1,1,47,1575,1528
1009,1,0,31,0,-31
1010,0,0,23,0,-23
1011,1,1,191,1254,1063
1012,1,0,13,0,-13
1013,1,0,18,0,-18
1014,1,1,93,1416,1323
1015,0,0,90,0,-90
1016,0,0,4,0,-4
1017,0,0,2,0,-2
1018,1,0,7,0,-7
1019,1,1,76,1270,1194
1020,0,0,55,0,-55
1021,0,0,1,0,-1
1022,0,0,25,0,-25
1023,0,0,1,0,-1
1024,1,1,160,1477,1317
1025,0,0,16,0,-16
1026,1,0,93,0,-93
1027,0,0,1,0,-1
1028,0,0,41,0,-41
1029,1,0,21,0,-21
1030,0,0,0,0,0
1031,0,0,79,0,-79
1032,0,0,7,0,-7
1033,0,0,127,0,-127
1034,0,0,25,0,-25
1035,1,0,48,0,-48
1036,0,0,46,0,-46
1037,1,1,171,1564,1393
1038,1,1,181,1729,1548
1039,1,1,60,1281,1221
1040,0,0,82,0,-82
1041,0,0,122,0,-122
1042,1,0,4,0,-4
1043,0,0,11,0,-11
1044,1,1,502,1284,782
1045,1,1,112,1298,1186
1046,1,1,216,1531,1315
1047,0,0,96,0,-96
1048,1,1,164,1345,1181
1049,0,0,19,0,-19
1050,1,1,2021,1377,-644
1051,0,0,44,0,-44
1052,0,0,12,0,-12
1053,1,1,556,1371,815
1054,0,0,38,0,-38
1055,0,0,46,0,-46
1056,0,0,14,0,-14
1057,0,0,75,0,-75
1058,1,0,62,0,-62
1059,0,0,120,0,-120
1060,0,0,57,0,-57
1061,0,0,51,0,-51
1062,0,0,3,0,-3
1063,0,0,97,0,-97
1064,0,0,24,0,-24
1065,0,0,31,0,-31
1066,1,0,13,0,-13
1067,1,0,52,0,-52
1068,0,0,102,0,-102
1069,1,0,134,0,-134
1070,1,1,370,1499,1129
1071,1,1,74,1626,1552
1072,1,1,1328,1986,658
1073,1,1,398,2331,1933
1074,1,1,178,1428,1250
1075,1,0,43,0,-43
1076,1,0,90,0,-90
1077,0,0,0,0,0
1078,1,0,14,0,-14
1079,0,0,3,0,-3
1080,1,0,5,0,-5
1081,1,1,48,1638,1590
1082,0,0,34,0,-34
1083,1,1,435,1576,1141
1084,0,0,5,0,-5
1085,0,0,64,0,-64
1086,0,0,163,0,-163
1087,0,0,104,0,-104
1088,1,1,603,1327,724
1089,1,0,61,0,-61
1090,0,0,21,0,-21
1091,0,0,72,0,-72
1092,1,0,13,0,-13
1093,0,0,62,0,-62
1094,1,0,2,0,-2
1095,1,0,15,0,-15
1096,1,1,201,1384,1183
1097,1,0,84,0,-84
1098,0,0,91,0,-91
1099,1,0,105,0,-105
1100,1,0,9,0,-9
1101,0,0,11,0,-11
1102,1,0,40,0,-40
1103,0,0,10,0,-10
1104,1,0,26,0,-26
1105,0,0,3,0,-3
1106,1,0,4,0,-4
1107,1,0,6,0,-6
1108,1,0,5,0,-5
1109,1,0,11,0,-11
1110,0,0,51,0,-51
1111,1,1,766,1529,763
1112,1,0,48,0,-48
1113,1,1,81,1498,1417
1114,0,0,51,0,-51
1115,0,0,1,0,-1
1116,1,0,6,0,-6
1117,0,0,36,0,-36
1118,0,0,10,0,-10
1119,1,1,638,3658,3020
1120,0,0,170,0,-170
1121,1,1,232,1569,1337
1122,0,0,23,0,-23
1123,1,0,39,0,-39
1124,0,0,50,0,-50
1125,0,0,41,0,-41
1126,0,0,148,0,-148
1127,1,0,26,0,-26
1128,1,0,105,0,-105
1129,0,0,28,0,-28
1130,0,0,5,0,-5
1131,1,1,447,1251,804
1132,1,1,144,1311,1167
1133,0,0,4,0,-4
1134,1,0,9,0,-9
1135,1,0,68,0,-68
1136,0,0,17,0,-17
1137,1,1,264,1399,1135
1138,0,0,0,0,0
1139,1,1,409,1365,956
1140,1,1,1370,1545,175
1141,0,0,30,0,-30
1142,0,0,7,0,-7
1143,0,0,63,0,-63
1144,1,1,238,1407,1169
1145,0,0,376,0,-376
1146,0,0,36,0,-36
1147,1,1,1053,1468,415
1148,0,0,49,0,-49
1149,1,1,173,1288,1115
1150,1,1,160,1986,1826
1151,1,0,19,0,-19
1152,0,0,44,0,-44
1153,1,1,151,1352,1201
1154,1,1,156,1452,1296
1155,0,0,13,0,-13
1156,1,1,168,1379,1211
1157,0,0,10,0,-10
1158,0,0,30,0,-30
1159,0,0,157,0,-157
1160,0,0,81,0,-81
1161,0,0,29,0,-29
1162,1,1,307,1352,1045
1163,1,0,13,0,-13
1164,0,0,22,0,-22
1165,0,0,72,0,-72
1166,0,0,1,0,-1
1167,0,0,108,0,-108
1168,0,0,47,0,-47
1169,0,0,31,0,-31
1170,1,1,948,2729,1781
1171,1,0,9,0,-9
1172,0,0,12,0,-12
1173,0,0,95,0,-95
1174,0,0,0,0,0
1175,1,1,1151,1496,345
1176,1,0,11,0,-11
1177,1,0,31,0,-31
1178,1,0,30,0,-30
1179,1,0,1,0,-1
1180,0,0,15,0,-15
1181,1,0,32,0,-32
1182,0,0,28,0,-28
1183,0,0,21,0,-21
1184,1,1,399,1586,1187
1185,1,1,445,1286,841
1186,1,1,1554,2168,614
1187,1,1,206,1429,1223
1188,1,1,328,1711,1383
1189,1,0,11,0,-11
1190,0,0,9,0,-9
1191,1,0,4,0,-4
1192,0,0,22,0,-22
1193,1,1,568,1906,1338
1194,1,1,119,1393,1274
1195,1,1,415,1260,845
1196,1,0,8,0,-8
1197,0,0,22,0,-22
1198,0,0,2,0,-2
1199,1,0,52,0,-52
1200,1,1,380,1456,1076
1201,0,0,0,0,0
1202,1,0,99,0,-99
1203,0,0,3,0,-3
1204,0,0,18,0,-18
1205,0,0,76,0,-76
1206,1,1,140,2303,2163
1207,1,1,132,1248,1116
1208,0,0,44,0,-44
1209,1,0,43,0,-43
1210,1,0,18,0,-18
1211,0,0,69,0,-69
1212,0,0,53,0,-53
1213,1,1,81,1381,1300
1214,1,0,207,0,-207
1215,1,0,228,0,-228
1216,0,0,85,0,-85
1217,1,1,1160,1320,160
1218,1,0,10,0,-10
1219,1,0,52,0,-52
1220,1,0,51,0,-51
1221,1,0,15,0,-15
1222,0,0,61,0,-61
1223,1,0,218,0,-218
1224,1,1,1177,1536,359
1225,1,1,836,1408,572
1226,1,0,105,0,-105
1227,0,0,72,0,-72
1228,0,0,0,0,0
1229,0,0,108,0,-108
1230,1,1,940,1395,455
1231,0,0,47,0,-47
1232,0,0,34,0,-34
1233,1,0,89,0,-89
1234,1,1,590,1374,784
1235,1,0,49,0,-49
1236,1,0,92,0,-92
1237,1,1,1165,2625,1460
1238,1,0,52,0,-52
1239,1,1,283,1289,1006
1240,1,1,311,1864,1553
1241,0,0,24,0,-24
1242,1,1,1359,1303,-56
1243,0,0,44,0,-44
1244,1,0,61,0,-61
1245,1,1,164,1307,1143
1246,0,0,9,0,-9
1247,1,0,55,0,-55
1248,1,1,211,1919,1708
1249,1,1,408,2191,1783
1250,1,0,5,0,-5
1251,1,0,6,0,-6
1252,0,0,28,0,-28
1253,1,0,63,0,-63
1254,1,0,32,0,-32
1255,0,0,201,0,-201
1256,1,1,173,1776,1603
1257,0,0,2,0,-2
1258,0,0,3,0,-3
1259,0,0,45,0,-45
1260,1,1,240,1733,1493
1261,0,0,124,0,-124
1262,1,1,1169,2622,1453
1263,0,0,36,0,-36
1264,0,0,10,0,-10
1265,0,0,40,0,-40
1266,0,0,28,0,-28
1267,1,1,255,1499,1244
1268,1,1,2085,1533,-552
1269,1,0,55,0,-55
1270,0,0,6,0,-6
1271,1,0,22,0,-22
1272,1,0,22,0,-22
1273,0,0,42,0,-42
1274,1,1,404,1441,1037
1275,1,1,660,1295,635
1276,1,1,285,1382,1097
1277,0,0,84,0,-84
1278,1,1,233,1636,1403
1279,0,0,2,0,-2
1280,0,0,4,0,-4
1281,1,1,316,1452,1136
1282,0,0,43,0,-43
1283,1,0,77,0,-77
1284,1,0,33,0,-33
1285,1,1,98,1284,1186
1286,1,0,39,0,-39
1287,1,0,3,0,-3
1288,0,0,22,0,-22
1289,1,0,7,0,-7
1290,0,0,96,0,-96
1291,1,0,28,0,-28
1292,1,1,1901,1594,-307
1293,0,0,41,0,-41
1294,0,0,9,0,-9
1295,1,0,75,0,-75
1296,1,1,545,1450,905
1297,1,0,3,0,-3
1298,1,0,72,0,-72
1299,1,1,656,1560,904
1300,1,1,1960,1246,-714
1301,1,0,155,0,-155
1302,0,0,11,0,-11
1303,0,0,25,0,-25
1304,0,0,9,0,-9
1305,1,0,19,0,-19
1306,1,1,878,1506,628
1307,1,1,741,1285,544
1308,1,1,174,1462,1288
1309,1,1,842,1367,525
1310,0,0,23,0,-23
1311,0,0,13,0,-13
1312,0,0,43,0,-43
1313,0,0,16,0,-16
1314,0,0,0,0,0
1315,0,0,57,0,-57
1316,1,1,59,2338,2279
1317,1,1,1606,2530,924
1318,0,0,111,0,-111
1319,0,0,16,0,-16
1320,1,1,691,1300,609
1321,0,0,37,0,-37
1322,1,0,4,0,-4
1323,1,0,3,0,-3
1324,0,0,69,0,-69
1325,1,0,25,0,-25
1326,1,0,26,0,-26
1327,1,1,206,1408,1202
1328,1,1,423,1448,1025
1329,0,0,67,0,-67
1330,0,0,147,0,-147
1331,1,1,402,3189,2787
1332,1,1,587,1258,671
1333,1,1,281,1523,1242
1334,1,0,2,0,-2
1335,0,0,45,0,-45
1336,0,0,86,0,-86
1337,1,0,37,0,-37
1338,1,0,0,0,0
1339,0,0,11,0,-11
1340,0,0,45,0,-45
1341,0,0,19,0,-19
1342,1,0,34,0,-34
1343,1,0,29,0,-29
1344,1,1,199,1294,1095
1345,1,1,145,1459,1314
1346,1,1,180,1350,1170
1347,0,0,65,0,-65
1348,0,0,150,0,-150
1349,0,0,137,0,-137
1350,0,0,132,0,-132
1351,1,0,84,0,-84
1352,1,1,598,1679,1081
1353,0,0,67,0,-67
1354,1,1,191,1691,1500
1355,1,1,446,1670,1224
1356,1,1,113,1558,1445
1357,1,0,52,0,-52
1358,0,0,23,0,-23
1359,0,0,17,0,-17
1360,1,0,5,0,-5
1361,0,0,55,0,-55
1362,1,1,2121,1340,-781
1363,1,0,264,0,-264
1364,1,0,15,0,-15
1365,1,0,3,0,-3
1366,0,0,23,0,-23
1367,1,1,90,1711,1621
1368,1,0,19,0,-19
1369,1,0,150,0,-150
1370,0,0,83,0,-83
1371,1,1,724,1407,683
1372,1,0,258,0,-258
1373,0,0,152,0,-152
1374,0,0,46,0,-46
1375,1,1,231,1257,1026
1376,0,0,53,0,-53
1377,1,1,218,1533,1315
1378,1,0,18,0,-18
1379,0,0,54,0,-54
1380,1,1,1564,1552,-12
1381,0,0,12,0,-12
1382,0,0,3,0,-3
1383,0,0,276,0,-276
1384,1,1,293,1575,1282
1385,1,0,11,0,-11
1386,0,0,59,0,-59
1387,1,0,28,0,-28
1388,1,1,307,1280,973
1389,0,0,20,0,-20
1390,0,0,74,0,-74
1391,1,0,8,0,-8
1392,1,1,115,1313,1198
1393,0,0,73,0,-73
1394,1,0,19,0,-19
1395,1,0,95,0,-95
1396,1,1,466,1235,769
1397,0,0,49,0,-49
1398,0,0,10,0,-10
1399,0,0,40,0,-40
1400,0,0,95,0,-95
1401,0,0,47,0,-47
1402,0,0,40,0,-40
1403,1,0,8,0,-8
1404,0,0,2,0,-2
1405,1,0,9,0,-9
1406,1,0,65,0,-65
1407,0,0,3,0,-3
1408,1,1,2341,2135,-206
1409,1,1,1904,1380,-524
1410,1,1,212,1951,1739
1411,0,0,10,0,-10
1412,0,0,80,0,-80
1413,1,1,855,1470,615
1414,0,0,7,0,-7
1415,1,1,260,1482,1222
1416,1,0,145,0,-145
1417,0,0,20,0,-20
1418,1,1,285,1364,1079
1419,1,0,20,0,-20
1420,0,0,64,0,-64
1421,1,1,264,1367,1103
1422,0,0,127,0,-127
1423,0,0,48,0,-48
1424,0,0,110,0,-110
1425,1,1,319,2618,2299
1426,1,0,6,0,-6
1427,1,0,12,0,-12
1428,0,0,3,0,-3
1429,1,0,15,0,-15
1430,1,1,1044,1614,570
1431,0,0,41,0,-41
1432,0,0,23,0,-23
1433,0,0,69,0,-69
1434,1,0,2,0,-2
1435,0,0,79,0,-79
1436,1,1,406,1320,914
1437,0,0,19,0,-19
1438,0,0,10,0,-10
1439,1,0,119,0,-119
1440,1,1,266,1282,1016
1441,0,0,29,0,-29
1442,1,1,68,1242,1174
1443,1,1,370,1568,1198
1444,1,1,666,1524,858
1445,1,0,14,0,-14
1446,1,0,12,0,-12
1447,1,1,45,1346,1301
1448,1,0,22,0,-22
1449,1,0,129,0,-129
1450,1,0,160,0,-160
1451,1,0,3,0,-3
1452,0,0,4,0,-4
1453,1,0,2,0,-2
1454,0,0,12,0,-12
1455,0,0,14,0,-14
1456,1,1,76,1423,1347
1457,1,1,929,1298,369
1458,0,0,44,0,-44
1459,1,0,55,0,-55
1460,1,0,45,0,-45
1461,1,1,1308,1368,60
1462,1,0,9,0,-9
1463,1,0,9,0,-9
1464,1,0,30,0,-30
1465,0,0,17,0,-17
1466,1,1,20,1318,1298
1467,0,0,119,0,-119
1468,1,1,290,1656,1366
1469,1,0,8,0,-8
1470,1,0,6,0,-6
1471,0,0,28,0,-28
1472,1,1,222,1240,1018
1473,1,0,27,0,-27
1474,1,0,11,0,-11
1475,1,0,37,0,-37
1476,0,0,34,0,-34
1477,1,0,2,0,-2
1478,0,0,4,0,-4
1479,0,0,22,0,-22
1480,1,0,5,0,-5
1481,0,0,182,0,-182
1482,1,0,2,0,-2
1483,1,1,1265,1247,-18
1484,0,0,11,0,-11
1485,1,0,30,0,-30
1486,1,0,54,0,-54
1487,0,0,76,0,-76
1488,1,0,16,0,-16
1489,1,0,54,0,-54
1490,1,0,3,0,-3
1491,1,0,86,0,-86
1492,1,0,71,0,-71
1493,1,0,31,0,-31
1494,1,1,408,1337,929
1495,1,0,54,0,-54
1496,0,0,12,0,-12
1497,1,0,63,0,-63
1498,1,0,67,0,-67
1499,1,0,35,0,-35
1500,1,1,183,1402,1219
1501,0,0,78,0,-78
1502,1,1,69,1253,1184
1503,0,0,10,0,-10
1504,0,0,53,0,-53
1505,1,0,26,0,-26
1506,1,0,88,0,-88
1507,1,0,51,0,-51
1508,1,0,55,0,-55
1509,1,0,33,0,-33
1510,0,0,112,0,-112
1511,1,0,28,0,-28
1512,1,1,1717,1528,-189
1513,1,1,135,2061,1926
1514,0,0,65,0,-65
1515,1,0,83,0,-83
1516,1,1,703,1595,892
1517,0,0,42,0,-42
1518,1,1,324,1516,1192
1519,1,1,866,1329,463
1520,0,0,34,0,-34
1521,0,0,44,0,-44
1522,1,1,265,1238,973
1523,0,0,31,0,-31
1524,0,0,14,0,-14
1525,1,0,42,0,-42
1526,0,0,32,0,-32
1527,1,1,217,1744,1527
1528,1,1,92,1330,1238
1529,1,1,822,1455,633
1530,0,0,6,0,-6
1531,0,0,18,0,-18
1532,1,1,162,1607,1445
1533,1,1,320,1508,1188
1534,1,0,54,0,-54
1535,1,0,151,0,-151
1536,1,0,14,0,-14
1537,0,0,31,0,-31
1538,0,0,66,0,-66
1539,1,1,284,1538,1254
1540,1,1,387,1427,1040
1541,1,0,28,0,-28
1542,0,0,53,0,-53
1543,0,0,10,0,-10
1544,1,0,9,0,-9
1545,1,1,560,1282,722
1546,1,0,68,0,-68
1547,1,0,2,0,-2
1548,0,0,21,0,-21
1549,1,1,614,2082,1468
1550,1,0,16,0,-16
1551,1,0,27,0,-27
1552,1,0,44,0,-44
1553,1,1,65,1262,1197
1554,0,0,53,0,-53
1555,1,1,234,2831,2597
1556,1,0,168,0,-168
1557,1,0,41,0,-41
1558,1,1,1011,1706,695
1559,0,0,37,0,-37
1560,1,0,18,0,-18
1561,1,0,19,0,-19
1562,1,1,430,1471,1041
1563,1,1,576,1247,671
1564,0,0,42,0,-42
1565,1,0,110,0,-110
1566,1,1,272,2671,2399
1567,1,1,704,1279,575
1568,1,1,164,1328,1164
1569,1,0,15,0,-15
1570,0,0,25,0,-25
1571,1,0,11,0,-11
1572,1,0,104,0,-104
1573,1,1,398,1629,1231
1574,0,0,85,0,-85
1575,0,0,85,0,-85
1576,1,1,207,1407,1200
1577,0,0,9,0,-9
1578,1,0,11,0,-11
1579,0,0,94,0,-94
1580,1,0,20,0,-20
1581,1,0,58,0,-58
1582,0,0,90,0,-90
1583,1,1,436,1672,1236
1584,1,1,1672,3747,2075
1585,1,1,449,1242,793
1586,0,0,18,0,-18
1587,0,0,28,0,-28
1588,1,0,5,0,-5
1589,1,1,790,1237,447
1590,0,0,1,0,-1
1591,0,0,50,0,-50
1592,1,1,39,1736,1697
1593,1,0,38,0,-38
1594,1,0,24,0,-24
1595,1,0,165,0,-165
1596,1,1,521,2011,1490
1597,1,1,256,1759,1503
1598,0,0,30,0,-30
1599,0,0,39,0,-39
1600,1,0,94,0,-94
1601,1,0,42,0,-42
1602,1,1,187,1248,1061
1603,1,1,1251,1665,414
1604,0,0,15,0,-15
1605,1,0,25,0,-25
1606,1,1,744,2166,1422
1607,1,0,64,0,-64
1608,0,0,37,0,-37
1609,0,0,5,0,-5
1610,0,0,101,0,-101
1611,0,0,58,0,-58
1612,0,0,1,0,-1
1613,0,0,103,0,-103
1614,1,0,14,0,-14
1615,1,0,15,0,-15
1616,1,0,83,0,-83
1617,0,0,31,0,-31
1618,1,0,82,0,-82
1619,1,0,87,0,-87
1620,1,0,146,0,-146
1621,0,0,23,0,-23
1622,0,0,101,0,-101
1623,0,0,33,0,-33
1624,1,1,316,1265,949
1625,1,1,1230,1513,283
1626,1,0,13,0,-13
1627,1,0,4,0,-4
1628,0,0,21,0,-21
1629,0,0,93,0,-93
1630,0,0,0,0,0
1631,1,0,540,0,-540
1632,1,0,3,0,-3
1633,0,0,1,0,-1
1634,1,1,415,2010,1595
1635,0,0,47,0,-47
1636,0,0,51,0,-51
1637,1,1,237,2022,1785
1638,1,0,27,0,-27
1639,0,0,314,0,-314
1640,0,0,132,0,-132
1641,1,0,3,0,-3
1642,1,0,24,0,-24
1643,0,0,70,0,-70
1644,0,0,88,0,-88
1645,1,0,33,0,-33
1646,1,1,949,1402,453
1647,1,0,91,0,-91
1648,0,0,2,0,-2
1649,0,0,149,0,-149
1650,0,0,13,0,-13
1651,0,0,113,0,-113
1652,0,0,45,0,-45
1653,1,1,1087,1649,562
1654,1,0,60,0,-60
1655,1,1,799,1364,565
1656,0,0,75,0,-75
1657,1,0,76,0,-76
1658,1,0,77,0,-77
1659,0,0,13,0,-13
1660,0,0,76,0,-76
1661,1,0,14,0,-14
1662,0,0,14,0,-14
1663,1,1,819,4749,3930
1664,0,0,347,0,-347
1665,1,1,1610,1589,-21
1666,1,0,45,0,-45
1667,1,1,542,1759,1217
1668,1,1,378,1472,1094
1669,1,1,430,2248,1818
1670,0,0,198,0,-198
1671,1,1,45,1261,1216
1672,0,0,0,0,0
1673,0,0,4,0,-4
1674,0,0,38,0,-38
1675,1,1,66,1369,1303
1676,0,0,5,0,-5
1677,1,0,15,0,-15
1678,1,0,128,0,-128
1679,1,1,126,3543,3417
1680,1,0,42,0,-42
1681,1,0,8,0,-8
1682,1,1,55,2427,2372
1683,1,0,42,0,-42
1684,1,1,448,1740,1292
1685,0,0,13,0,-13
1686,1,1,612,1744,1132
1687,1,0,19,0,-19
1688,1,0,12,0,-12
1689,0,0,5,0,-5
1690,1,1,130,1456,1326
1691,1,1,996,3062,2066
1692,0,0,35,0,-35
1693,0,0,56,0,-56
1694,1,1,322,1605,1283
1695,1,0,42,0,-42
1696,1,0,14,0,-14
1697,1,1,212,1417,1205
1698,0,0,50,0,-50
1699,1,0,7,0,-7
1700,1,0,166,0,-166
1701,1,1,252,1845,1593
1702,0,0,15,0,-15
1703,1,0,15,0,-15
1704,1,0,33,0,-33
1705,1,0,110,0,-110
1706,0,0,86,0,-86
1707,1,0,68,0,-68
1708,0,0,124,0,-124
1709,0,0,1,0,-1
1710,1,1,376,1720,1344
1711,1,1,98,1981,1883
1712,1,1,325,1456,1131
1713,1,1,700,1658,958
1714,1,1,302,1244,942
1715,1,0,13,0,-13
1716,0,0,33,0,-33
1717,1,1,355,1318,963
1718,0,0,54,0,-54
1719,1,0,78,0,-78
1720,1,0,5,0,-5
1721,0,0,20,0,-20
1722,1,1,854,1445,591
1723,1,0,30,0,-30
1724,0,0,78,0,-78
1725,0,0,64,0,-64
1726,0,0,28,0,-28
1727,1,0,13,0,-13
1728,0,0,14,0,-14
1729,1,0,37,0,-37
1730,1,0,15,0,-15
1731,1,1,749,1474,725
1732,0,0,148,0,-148
1733,1,1,766,1423,657
1734,0,0,62,0,-62
1735,1,1,551,1352,801
1736,0,0,41,0,-41
1737,0,0,21,0,-21
1738,1,1,1544,1357,-187
1739,0,0,36,0,-36
1740,1,0,32,0,-32
1741,0,0,21,0,-21
1742,1,1,569,1269,700
1743,0,0,109,0,-109
1744,1,1,3586,1276,-2310
1745,0,0,76,0,-76
1746,0,0,173,0,-173
1747,0,0,1,0,-1
1748,1,1,795,1582,787
1749,0,0,50,0,-50
1750,0,0,30,0,-30
1751,1,1,340,1253,913
1752,0,0,35,0,-35
1753,0,0,6,0,-6
1754,0,0,23,0,-23
1755,0,0,0,0,0
1756,1,1,1474,2066,592
1757,1,1,493,2914,2421
1758,1,0,21,0,-21
1759,0,0,41,0,-41
1760,1,0,27,0,-27
1761,0,0,112,0,-112
1762,0,0,21,0,-21
1763,0,0,27,0,-27
1764,0,0,7,0,-7
1765,1,0,212,0,-212
1766,0,0,72,0,-72
1767,1,1,578,1596,1018
1768,0,0,105,0,-105
1769,1,0,21,0,-21
1770,0,0,7,0,-7
1771,1,0,18,0,-18
1772,1,1,68,1647,1579
1773,1,0,28,0,-28
1774,0,0,85,0,-85
1775,0,0,41,0,-41
1776,1,0,31,0,-31
1777,1,0,83,0,-83
1778,0,0,79,0,-79
1779,0,0,19,0,-19
1780,0,0,41,0,-41
1781,0,0,4,0,-4
1782,1,1,93,1373,1280
1783,1,1,1175,1353,178
1784,1,1,375,2057,1682
1785,1,0,26,0,-26
1786,1,0,10,0,-10
1787,1,1,255,1632,1377
1788,0,0,69,0,-69
1789,1,0,18,0,-18
1790,1,0,8,0,-8
1791,0,0,108,0,-108
1792,1,1,277,1862,1585
1793,1,1,78,1264,1186
1794,1,0,49,0,-49
1795,1,1,308,1327,1019
1796,1,1,608,1491,883
1797,1,0,42,0,-42
1798,1,1,1084,1584,500
1799,1,0,16,0,-16
1800,1,0,217,0,-217
1801,0,0,3,0,-3
1802,1,1,81,3683,3602
1803,0,0,21,0,-21
1804,1,1,209,1421,1212
1805,1,1,224,1470,1246
1806,0,0,21,0,-21
1807,0,0,31,0,-31
1808,0,0,117,0,-117
1809,1,1,790,1410,620
1810,0,0,8,0,-8
1811,0,0,33,0,-33
1812,1,1,153,1551,1398
1813,1,0,53,0,-53
1814,0,0,15,0,-15
1815,0,0,72,0,-72
1816,1,0,7,0,-7
1817,1,1,1047,1686,639
1818,1,0,55,0,-55
1819,1,1,223,1537,1314
1820,1,0,5,0,-5
1821,1,0,153,0,-153
1822,1,1,413,1383,970
1823,1,0,21,0,-21
1824,0,0,144,0,-144
1825,0,0,65,0,-65
1826,0,0,24,0,-24
1827,1,0,36,0,-36
1828,0,0,24,0,-24
1829,1,0,26,0,-26
1830,0,0,10,0,-10
1831,1,1,537,1951,1414
1832,0,0,0,0,0
1833,0,0,25,0,-25
1834,0,0,1,0,-1
1835,1,1,414,1688,1274
1836,1,1,1314,1278,-36
1837,0,0,111,0,-111
1838,0,0,11,0,-11
1839,1,1,1915,2641,726
1840,1,0,90,0,-90
1841,0,0,163,0,-163
1842,0,0,121,0,-121
1843,1,1,87,1347,1260
1844,0,0,26,0,-26
1845,1,1,1036,1754,718
1846,0,0,197,0,-197
1847,0,0,29,0,-29
1848,0,0,41,0,-41
1849,1,0,47,0,-47
1850,0,0,19,0,-19
1851,0,0,9,0,-9
1852,1,0,4,0,-4
1853,1,0,42,0,-42
1854,1,1,1337,1799,462
1855,0,0,10,0,-10
1856,1,1,520,1406,886
1857,1,0,230,0,-230
1858,1,1,922,3711,2789
1859,0,0,48,0,-48
1860,1,0,7,0,-7
1861,0,0,1,0,-1
1862,1,1,1366,2576,1210
1863,1,1,494,1799,1305
1864,1,0,19,0,-19
1865,1,1,481,3029,2548
1866,0,0,30,0,-30
1867,1,0,17,0,-17
1868,1,1,480,2457,1977
1869,1,0,60,0,-60
1870,0,0,19,0,-19
1871,1,0,165,0,-165
1872,1,1,286,1489,1203
1873,1,0,39,0,-39
1874,0,0,35,0,-35
1875,0,0,120,0,-120
1876,1,0,3,0,-3
1877,1,0,54,0,-54
1878,1,1,116,1401,1285
1879,0,0,160,0,-160
1880,0,0,28,0,-28
1881,1,1,346,1810,1464
1882,0,0,91,0,-91
1883,1,0,49,0,-49
1884,1,1,49,1388,1339
1885,1,1,251,1322,1071
1886,0,0,75,0,-75
1887,1,1,140,1510,1370
1888,0,0,87,0,-87
1889,1,1,1242,1535,293
1890,1,0,8,0,-8
1891,0,0,110,0,-110
1892,1,1,723,1740,1017
1893,1,0,4,0,-4
1894,0,0,11,0,-11
1895,1,0,16,0,-16
1896,1,1,397,1273,876
1897,1,0,91,0,-91
1898,1,1,354,1405,1051
1899,1,1,504,1894,1390
1900,1,1,163,1372,1209
1901,1,1,751,1354,603
1902,0,0,170,0,-170
1903,1,0,31,0,-31
1904,0,0,47,0,-47
1905,0,0,69,0,-69
1906,1,1,2430,1432,-998
1907,1,1,193,1538,1345
1908,1,1,498,1960,1462
1909,1,0,22,0,-22
1910,0,0,8,0,-8
1911,1,1,1026,1469,443
1912,0,0,137,0,-137
1913,1,0,51,0,-51
1914,0,0,21,0,-21
1915,0,0,8,0,-8
1916,0,0,15,0,-15
1917,1,0,28,0,-28
1918,1,0,25,0,-25
1919,1,0,3,0,-3
1920,0,0,5,0,-5
1921,1,0,22,0,-22
1922,1,0,72,0,-72
1923,1,1,951,1898,947
1924,1,1,208,1581,1373
1925,1,1,261,1297,1036
1926,1,0,1,0,-1
1927,1,1,134,2204,2070
1928,0,0,26,0,-26
1929,1,1,144,2190,2046
1930,1,1,1949,1361,-588
1931,1,1,433,1799,1366
1932,1,1,344,1635,1291
1933,1,0,6,0,-6
1934,1,1,21,3007,2986
1935,0,0,13,0,-13
1936,1,1,86,1382,1296
1937,1,1,520,2590,2070
1938,1,1,45,1794,1749
1939,1,1,591,1449,858
1940,1,1,225,1541,1316
1941,0,0,105,0,-105
1942,1,0,13,0,-13
1943,1,1,171,1805,1634
1944,1,1,546,1453,907
1945,1,1,1350,1575,225
1946,0,0,14,0,-14
1947,0,0,4,0,-4
1948,0,0,23,0,-23
1949,1,1,2109,2649,540
1950,0,0,6,0,-6
1951,1,0,44,0,-44
1952,1,1,2002,1597,-405
1953,1,0,2,0,-2
1954,0,0,76,0,-76
1955,0,0,29,0,-29
1956,1,1,697,1511,814
1957,0,0,47,0,-47
1958,0,0,5,0,-5
1959,0,0,26,0,-26
1960,0,0,67,0,-67
1961,1,0,62,0,-62
1962,0,0,95,0,-95
1963,1,1,58,1746,1688
1964,1,1,251,2127,1876
1965,1,1,315,1707,1392
1966,1,0,88,0,-88
1967,1,1,688,1274,586
1968,0,0,10,0,-10
1969,1,0,38,0,-38
1970,1,0,41,0,-41
1971,0,0,83,0,-83
1972,0,0,72,0,-72
1973,1,0,21,0,-21
1974,0,0,5,0,-5
1975,1,0,134,0,-134
1976,0,0,19,0,-19
1977,0,0,90,0,-90
1978,1,0,2,0,-2
1979,1,0,14,0,-14
1980,0,0,30,0,-30
1981,1,0,100,0,-100
1982,0,0,23,0,-23
1983,1,0,35,0,-35
1984,1,1,709,1578,869
1985,1,0,165,0,-165
1986,1,1,84,1347,1263
1987,0,0,41,0,-41
1988,0,0,72,0,-72
1989,1,0,136,0,-136
1990,1,0,25,0,-25
1991,1,1,852,1252,400
1992,1,0,84,0,-84
1993,1,0,38,0,-38
1994,0,0,15,0,-15
1995,0,0,60,0,-60
1996,1,1,142,1505,1363
1997,1,0,178,0,-178
1998,0,0,47,0,-47
1999,1,1,484,1262,778
2000,1,0,106,0,-106
2001,1,1,32,1406,1374
2002,0,0,67,0,-67
2003,0,0,66,0,-66
2004,1,1,1602,1321,-281
2005,0,0,21,0,-21
2006,0,0,10,0,-10
2007,1,1,447,1328,881
2008,1,0,32,0,-32
2009,1,1,658,1245,587
2010,0,0,88,0,-88
2011,1,1,958,1290,332
2012,0,0,30,0,-30
2013,0,0,137,0,-137
2014,1,1,714,1363,649
2015,1,0,3,0,-3
2016,0,0,19,0,-19
2017,1,1,1875,2247,372
2018,1,0,40,0,-40
2019,1,1,230,1452,1222
2020,1,0,4,0,-4
2021,1,0,43,0,-43
2022,1,0,25,0,-25
2023,0,0,25,0,-25
2024,1,0,20,0,-20
2025,0,0,31,0,-31
2026,0,0,71,0,-71
2027,1,1,251,2082,1831
2028,1,1,208,1972,1764
2029,0,0,4,0,-4
2030,1,0,58,0,-58
2031,1,1,326,1263,937
2032,1,0,38,0,-38
2033,1,0,27,0,-27
2034,1,0,111,0,-111
2035,0,0,43,0,-43
2036,1,0,9,0,-9
2037,0,0,5,0,-5
2038,0,0,29,0,-29
2039,1,0,5,0,-5
2040,0,0,161,0,-161
2041,0,0,15,0,-15
2042,1,0,29,0,-29
2043,1,1,456,4422,3966
2044,0,0,11,0,-11
2045,0,0,70,0,-70
2046,0,0,108,0,-108
2047,1,1,34,1362,1328
2048,0,0,16,0,-16
2049,0,0,30,0,-30
2050,1,0,54,0,-54
2051,1,0,58,0,-58
2052,0,0,47,0,-47
2053,0,0,90,0,-90
2054,1,1,349,1601,1252
2055,1,0,32,0,-32
2056,1,1,134,1481,1347
2057,1,0,18,0,-18
2058,1,0,90,0,-90
2059,1,1,2639,1839,-800
2060,0,0,36,0,-36
2061,1,1,218,1439,1221
2062,0,0,17,0,-17
2063,0,0,7,0,-7
2064,0,0,5,0,-5
2065,0,0,35,0,-35
2066,1,0,26,0,-26
2067,0,0,39,0,-39
2068,1,1,112,1699,1587
2069,1,0,62,0,-62
2070,1,1,86,6046,5960
2071,0,0,8,0,-8
2072,0,0,35,0,-35
2073,0,0,60,0,-60
2074,1,1,155,1238,1083
2075,1,1,675,1322,647
2076,0,0,79,0,-79
2077,1,1,386,1236,850
2078,1,0,26,0,-26
2079,1,1,2552,1695,-857
2080,0,0,63,0,-63
2081,1,1,710,1781,1071
2082,0,0,85,0,-85
2083,0,0,51,0,-51
2084,0,0,13,0,-13
2085,1,0,79,0,-79
2086,1,0,39,0,-39
2087,1,1,1009,2273,1264
2088,0,0,207,0,-207
2089,1,0,44,0,-44
2090,1,1,273,1613,1340
2091,1,1,402,1297,895
2092,0,0,129,0,-129
2093,0,0,142,0,-142
2094,1,0,56,0,-56
2095,1,1,137,1422,1285
2096,1,0,31,0,-31
2097,1,0,3,0,-3
2098,1,0,6,0,-6
2099,1,0,0,0,0
2100,1,1,805,1540,735
2101,1,1,77,1550,1473
2102,1,0,25,0,-25
2103,0,0,37,0,-37
2104,1,0,17,0,-17
2105,1,0,24,0,-24
2106,1,0,50,0,-50
2107,0,0,3,0,-3
2108,0,0,55,0,-55
2109,1,1,240,1278,1038
2110,1,0,33,0,-33
2111,0,0,139,0,-139
2112,1,0,3,0,-3
2113,1,0,77,0,-77
2114,0,0,74,0,-74
2115,0,0,6,0,-6
2116,0,0,10,0,-10
2117,0,0,35,0,-35
2118,1,0,77,0,-77
2119,0,0,101,0,-101
2120,1,0,32,0,-32
2121,0,0,95,0,-95
2122,0,0,42,0,-42
2123,0,0,191,0,-191
2124,0,0,75,0,-75
2125,1,0,41,0,-41
2126,0,0,26,0,-26
2127,1,1,290,1349,1059
2128,0,0,163,0,-163
2129,1,1,149,1259,1110
2130,0,0,39,0,-39
2131,0,0,23,0,-23
2132,0,0,47,0,-47
2133,0,0,5,0,-5
2134,1,1,95,1288,1193
2135,1,0,37,0,-37
2136,1,1,172,1396,1224
2137,0,0,87,0,-87
2138,0,0,66,0,-66
2139,1,1,1121,1425,304
2140,1,0,29,0,-29
2141,1,1,581,1270,689
2142,1,1,459,2012,1553
2143,1,1,569,2145,1576
2144,0,0,6,0,-6
2145,1,1,176,1788,1612
2146,0,0,37,0,-37
2147,1,1,2021,1443,-578
2148,1,0,26,0,-26
2149,1,0,15,0,-15
2150,0,0,33,0,-33
2151,1,0,9,0,-9
2152,1,0,68,0,-68
2153,1,0,20,0,-20
2154,0,0,150,0,-150
2155,0,0,116,0,-116
2156,0,0,76,0,-76
2157,1,0,0,0,0
2158,1,1,1401,1467,66
2159,1,1,551,1487,936
2160,1,0,97,0,-97
2161,0,0,19,0,-19
2162,1,0,19,0,-19
2163,1,0,111,0,-111
2164,1,0,136,0,-136
2165,1,1,756,1494,738
2166,1,1,113,1263,1150
2167,1,0,61,0,-61
2168,1,1,207,1398,1191
2169,1,1,79,1492,1413
2170,0,0,39,0,-39
2171,1,1,631,1503,872
2172,0,0,8,0,-8
2173,0,0,0,0,0
2174,0,0,20,0,-20
2175,0,0,113,0,-113
2176,1,0,34,0,-34
2177,0,0,9,0,-9
2178,1,1,53,1382,1329
2179,1,1,541,1677,1136
2180,0,0,11,0,-11
2181,0,0,45,0,-45
2182,0,0,67,0,-67
2183,0,0,28,0,-28
2184,0,0,5,0,-5
2185,0,0,0,0,0
2186,0,0,128,0,-128
2187,0,0,59,0,-59
2188,0,0,53,0,-53
2189,0,0,3,0,-3
2190,1,0,35,0,-35
2191,1,1,1049,2171,1122
2192,1,1,348,1763,1415
2193,1,0,5,0,-5
2194,0,0,200,0,-200
2195,1,1,507,1768,1261
2196,0,0,89,0,-89
2197,1,1,1004,1360,356
2198,1,0,163,0,-163
2199,1,1,601,1518,917
2200,1,0,2,0,-2
2201,1,0,0,0,0
2202,1,0,11,0,-11
2203,1,1,1074,1300,226
2204,0,0,36,0,-36
2205,1,1,1125,1819,694
2206,1,1,3367,1257,-2110
2207,0,0,12,0,-12
2208,1,1,360,2291,1931
2209,1,1,169,2853,2684
2210,1,1,961,1497,536
2211,1,1,410,1578,1168
2212,0,0,35,0,-35
2213,0,0,93,0,-93
2214,0,0,31,0,-31
2215,1,1,1126,1493,367
2216,0,0,31,0,-31
2217,0,0,18,0,-18
2218,0,0,63,0,-63
2219,0,0,20,0,-20
2220,1,1,478,1362,884
2221,1,1,207,1313,1106
2222,0,0,45,0,-45
2223,0,0,7,0,-7
2224,1,0,25,0,-25
2225,1,0,90,0,-90
2226,1,0,60,0,-60
2227,1,1,279,1260,981
2228,1,0,139,0,-139
2229,1,0,47,0,-47
2230,0,0,66,0,-66
2231,0,0,72,0,-72
2232,1,0,63,0,-63
2233,1,1,1438,1654,216
2234,0,0,6,0,-6
2235,1,0,57,0,-57
2236,0,0,9,0,-9
2237,1,0,7,0,-7
2238,0,0,48,0,-48
2239,0,0,64,0,-64
2240,0,0,10,0,-10
2241,1,1,141,2021,1880
2242,1,0,60,0,-60
2243,1,1,504,1693,1189
2244,0,0,108,0,-108
2245,1,1,720,1862,1142
2246,0,0,6,0,-6
2247,0,0,44,0,-44
2248,1,0,40,0,-40
2249,1,0,11,0,-11
2250,0,0,37,0,-37
2251,0,0,130,0,-130
2252,0,0,139,0,-139
2253,1,1,211,1367,1156
2254,1,0,23,0,-23
2255,1,1,88,1261,1173
2256,1,0,40,0,-40
2257,1,1,1063,1468,405
2258,1,1,1299,3187,1888
2259,1,1,351,1237,886
2260,0,0,49,0,-49
2261,0,0,87,0,-87
2262,0,0,10,0,-10
2263,0,0,90,0,-90
2264,1,1,859,2635,1776
2265,1,0,46,0,-46
2266,1,1,175,1548,1373
2267,1,0,9,0,-9
2268,1,0,48,0,-48
2269,0,0,10,0,-10
2270,1,0,206,0,-206
2271,1,1,30,1290,1260
2272,1,0,190,0,-190
2273,1,0,86,0,-86
2274,0,0,20,0,-20
2275,1,1,1904,2520,616
2276,0,0,5,0,-5
2277,1,0,31,0,-31
2278,0,0,61,0,-61
2279,1,0,31,0,-31
2280,1,0,26,0,-26
2281,1,0,57,0,-57
2282,0,0,60,0,-60
2283,1,0,9,0,-9
2284,1,1,741,1254,513
2285,1,1,709,2263,1554
2286,1,1,614,1250,636
2287,1,1,205,1281,1076
2288,1,1,23,1242,1219
2289,1,1,207,1522,1315
2290,0,0,128,0,-128
2291,0,0,62,0,-62
2292,1,1,179,2151,1972
2293,0,0,103,0,-103
2294,0,0,168,0,-168
2295,0,0,35,0,-35
2296,0,0,40,0,-40
2297,1,0,3,0,-3
2298,0,0,49,0,-49
2299,1,0,48,0,-48
2300,1,1,720,2634,1914
2301,1,0,146,0,-146
2302,1,1,1172,1307,135
2303,1,0,144,0,-144
2304,0,0,89,0,-89
2305,0,0,21,0,-21
2306,1,0,29,0,-29
2307,0,0,30,0,-30
2308,1,0,152,0,-152
2309,1,0,92,0,-92
2310,0,0,99,0,-99
2311,0,0,109,0,-109
2312,0,0,45,0,-45
2313,1,1,810,1701,891
2314,1,1,2259,1632,-627
2315,1,1,475,1716,1241
2316,0,0,23,0,-23
2317,1,0,98,0,-98
2318,0,0,97,0,-97
2319,0,0,9,0,-9
2320,0,0,49,0,-49
2321,1,0,0,0,0
2322,0,0,18,0,-18
2323,1,0,33,0,-33
2324,0,0,27,0,-27
2325,1,0,128,0,-128
2326,1,1,386,1264,878
2327,1,0,9,0,-9
2328,1,1,782,1384,602
2329,1,1,594,1393,799
2330,0,0,7,0,-7
2331,1,1,63,1442,1379
2332,0,0,148,0,-148
2333,1,1,13,1259,1246
2334,0,0,167,0,-167
2335,1,0,4,0,-4
2336,0,0,51,0,-51
2337,1,0,134,0,-134
2338,1,1,673,1460,787
2339,0,0,120,0,-120
2340,1,0,20,0,-20
2341,1,0,222,0,-222
2342,1,0,5,0,-5
2343,0,0,33,0,-33
2344,0,0,66,0,-66
2345,1,0,17,0,-17
2346,1,0,76,0,-76
2347,1,1,844,1338,494
2348,1,1,230,1792,1562
2349,1,1,866,1589,723
2350,1,1,411,1244,833
2351,0,0,46,0,-46
2352,0,0,53,0,-53
2353,0,0,47,0,-47
2354,1,0,0,0,0
2355,0,0,35,0,-35
2356,0,0,15,0,-15
2357,1,0,15,0,-15
2358,1,0,63,0,-63
2359,1,0,29,0,-29
2360,1,1,990,2016,1026
2361,1,0,55,0,-55
2362,0,0,185,0,-185
2363,1,0,6,0,-6
2364,0,0,81,0,-81
2365,1,0,20,0,-20
2366,1,1,350,2624,2274
2367,1,1,346,2179,1833
2368,1,0,37,0,-37
2369,0,0,59,0,-59
2370,1,1,432,1250,818
2371,1,0,12,0,-12
2372,0,0,36,0,-36
2373,0,0,13,0,-13
2374,1,1,103,1762,1659
2375,1,1,918,1678,760
2376,1,1,199,1678,1479
2377,1,1,648,2942,2294
2378,0,0,11,0,-11
2379,0,0,50,0,-50
2380,1,1,241,1447,1206
2381,1,0,111,0,-111
2382,1,1,339,3587,3248
2383,1,1,313,1381,1068
2384,0,0,72,0,-72
2385,0,0,5,0,-5
2386,1,0,44,0,-44
2387,1,1,1977,1264,-713
2388,0,0,117,0,-117
2389,0,0,101,0,-101
2390,0,0,1,0,-1
2391,1,0,86,0,-86
2392,1,1,518,1797,1279
2393,1,1,86,1533,1447
2394,0,0,28,0,-28
2395,1,1,2070,1444,-626
2396,1,0,13,0,-13
2397,1,1,238,3050,2812
2398,1,0,12,0,-12
2399,1,1,256,1269,1013
2400,1,0,100,0,-100
2401,1,0,92,0,-92
2402,0,0,155,0,-155
2403,1,0,15,0,-15
2404,0,0,8,0,-8
2405,0,0,84,0,-84
2406,1,1,107,1290,1183
2407,1,0,28,0,-28
2408,1,1,222,1696,1474
2409,1,1,716,1544,828
2410,0,0,43,0,-43
2411,0,0,183,0,-183
2412,1,0,165,0,-165
2413,0,0,4,0,-4
2414,1,0,40,0,-40
2415,1,0,20,0,-20
2416,1,0,20,0,-20
2417,1,0,2,0,-2
2418,1,0,70,0,-70
2419,0,0,4,0,-4
2420,1,0,90,0,-90
2421,1,0,43,0,-43
2422,1,1,369,1358,989
2423,0,0,81,0,-81
2424,1,0,77,0,-77
2425,1,1,55,1620,1565
2426,0,0,56,0,-56
2427,1,1,2402,1516,-886
2428,0,0,20,0,-20
2429,1,0,13,0,-13
2430,0,0,22,0,-22
2431,1,0,16,0,-16
2432,0,0,22,0,-22
2433,1,0,110,0,-110
2434,0,0,26,0,-26
2435,1,0,3,0,-3
2436,1,0,9,0,-9
2437,0,0,100,0,-100
2438,0,0,88,0,-88
2439,1,1,44,1338,1294
2440,1,1,311,2474,2163
2441,0,0,7,0,-7
2442,0,0,59,0,-59
2443,1,1,909,1376,467
2444,0,0,112,0,-112
2445,0,0,22,0,-22
2446,0,0,106,0,-106
2447,1,0,76,0,-76
2448,1,1,1981,1509,-472
2449,1,0,44,0,-44
2450,1,1,63,2312,2249
2451,0,0,53,0,-53
2452,1,0,55,0,-55
2453,0,0,24,0,-24
2454,1,0,16,0,-16
2455,1,0,57,0,-57
2456,0,0,58,0,-58
2457,1,1,575,1328,753
2458,1,1,195,1334,1139
2459,1,0,83,0,-83
2460,1,1,677,1423,746
2461,0,0,30,0,-30
2462,1,1,181,1469,1288
2463,1,0,42,0,-42
2464,1,0,14,0,-14
2465,0,0,23,0,-23
2466,0,0,56,0,-56
2467,1,1,497,1284,787
2468,0,0,26,0,-26
2469,1,0,48,0,-48
2470,0,0,59,0,-59
2471,0,0,137,0,-137
2472,1,0,52,0,-52
2473,0,0,24,0,-24
2474,0,0,6,0,-6
2475,0,0,63,0,-63
2476,0,0,73,0,-73
2477,1,0,74,0,-74
2478,1,1,558,2131,1573
2479,1,1,264,1521,1257
2480,0,0,156,0,-156
2481,1,1,141,1504,1363
2482,1,0,114,0,-114
2483,1,1,442,2155,1713
2484,1,0,76,0,-76
2485,0,0,15,0,-15
2486,1,1,923,1236,313
2487,0,0,17,0,-17
2488,0,0,26,0,-26
2489,1,1,62,3095,3033
2490,1,0,63,0,-63
2491,0,0,11,0,-11
2492,1,1,147,1377,1230
2493,1,1,126,1477,1351
2494,0,0,33,0,-33
2495,0,0,16,0,-16
2496,1,0,10,0,-10
2497,0,0,7,0,-7
2498,0,0,40,0,-40
2499,1,0,67,0,-67
2500,1,1,1407,2092,685
2501,0,0,37,0,-37
2502,1,0,39,0,-39
2503,1,1,177,1369,1192
2504,1,0,28,0,-28
2505,1,0,15,0,-15
2506,1,1,37,1264,1227
2507,1,0,125,0,-125
2508,1,1,272,1257,985
2509,0,0,33,0,-33
2510,1,1,141,1553,1412
2511,0,0,12,0,-12
2512,1,0,10,0,-10
2513,0,0,171,0,-171
2514,1,1,463,1334,871
2515,0,0,28,0,-28
2516,0,0,66,0,-66
2517,1,0,19,0,-19
2518,1,1,513,1378,865
2519,0,0,76,0,-76
2520,1,1,107,1623,1516
2521,0,0,16,0,-16
2522,0,0,44,0,-44
2523,0,0,37,0,-37
2524,1,0,28,0,-28
2525,0,0,84,0,-84
2526,1,1,512,1291,779
2527,0,0,0,0,0
2528,1,0,7,0,-7
2529,0,0,6,0,-6
2530,1,0,194,0,-194
2531,1,0,186,0,-186
2532,1,0,53,0,-53
2533,0,0,131,0,-131
2534,1,1,217,3993,3776
2535,1,1,521,1640,1119
2536,0,0,18,0,-18
2537,0,0,10,0,-10
2538,1,1,73,1491,1418
2539,1,1,366,1324,958
2540,0,0,13,0,-13
2541,0,0,62,0,-62
2542,1,0,119,0,-119
2543,0,0,45,0,-45
2544,0,0,13,0,-13
2545,0,0,2,0,-2
2546,1,0,5,0,-5
2547,1,1,2119,1346,-773
2548,0,0,53,0,-53
2549,0,0,69,0,-69
2550,1,1,1310,1784,474
2551,1,0,14,0,-14
2552,1,1,321,1319,998
2553,1,1,2715,1421,-1294
2554,0,0,17,0,-17
2555,1,0,22,0,-22
2556,0,0,8,0,-8
2557,1,0,122,0,-122
2558,0,0,1,0,-1
2559,1,1,133,1373,1240
2560,0,0,88,0,-88
2561,0,0,4,0,-4
2562,0,0,74,0,-74
2563,1,0,104,0,-104
2564,1,0,53,0,-53
2565,1,1,118,2009,1891
2566,1,1,290,1542,1252
2567,1,1,103,1242,1139
2568,1,0,2,0,-2
2569,1,1,458,1416,958
2570,1,0,61,0,-61
2571,1,0,54,0,-54
2572,0,0,7,0,-7
2573,1,0,22,0,-22
2574,0,0,35,0,-35
2575,0,0,30,0,-30
2576,0,0,84,0,-84
2577,0,0,22,0,-22
2578,1,0,7,0,-7
2579,1,1,411,1277,866
2580,1,1,392,1652,1260
2581,1,0,1,0,-1
2582,0,0,43,0,-43
2583,1,1,1724,1477,-247
2584,0,0,22,0,-22
2585,0,0,143,0,-143
2586,0,0,103,0,-103
2587,1,0,3,0,-3
2588,1,1,218,1456,1238
2589,1,1,875,1432,557
2590,1,1,1316,1439,123
2591,1,0,25,0,-25
2592,0,0,20,0,-20
2593,0,0,70,0,-70
2594,0,0,26,0,-26
2595,1,0,10,0,-10
2596,1,0,36,0,-36
2597,0,0,32,0,-32
2598,0,0,19,0,-19
2599,1,0,4,0,-4
2600,0,0,28,0,-28
2601,1,1,811,1426,615
2602,1,1,376,1277,901
2603,1,1,374,1291,917
2604,0,0,70,0,-70
2605,0,0,105,0,-105
2606,1,1,293,1338,1045
2607,0,0,117,0,-117
2608,1,0,27,0,-27
2609,0,0,84,0,-84
2610,0,0,79,0,-79
2611,1,0,23,0,-23
2612,0,0,31,0,-31
2613,1,1,761,1273,512
2614,0,0,24,0,-24
2615,1,1,290,1668,1378
2616,1,1,480,1239,759
2617,0,0,51,0,-51
2618,1,0,50,0,-50
2619,1,0,312,0,-312
2620,0,0,141,0,-141
2621,1,1,352,2187,1835
2622,0,0,9,0,-9
2623,0,0,6,0,-6
2624,1,1,1532,1297,-235
2625,0,0,41,0,-41
2626,1,0,18,0,-18
2627,1,1,112,1376,1264
2628,1,0,9,0,-9
2629,1,0,65,0,-65
2630,0,0,100,0,-100
2631,1,1,23,1277,1254
2632,1,1,389,1759,1370
2633,0,0,1,0,-1
2634,0,0,0,0,0
2635,0,0,34,0,-34
2636,0,0,26,0,-26
2637,0,0,26,0,-26
2638,0,0,100,0,-100
2639,0,0,2,0,-2
2640,0,0,28,0,-28
2641,1,1,207,1871,1664
2642,1,0,75,0,-75
2643,0,0,42,0,-42
2644,1,0,18,0,-18
2645,1,1,1359,1579,220
2646,1,1,925,1640,715
2647,1,0,53,0,-53
2648,0,0,45,0,-45
2649,0,0,204,0,-204
2650,1,0,44,0,-44
2651,1,0,2,0,-2
2652,1,1,282,1408,1126
2653,0,0,97,0,-97
2654,1,0,96,0,-96
2655,1,0,17,0,-17
2656,1,0,10,0,-10
2657,0,0,149,0,-149
2658,0,0,110,0,-110
2659,1,0,5,0,-5
2660,0,0,23,0,-23
2661,0,0,21,0,-21
2662,0,0,28,0,-28
2663,0,0,7,0,-7
2664,1,0,8,0,-8
2665,0,0,10,0,-10
2666,1,0,5,0,-5
2667,0,0,91,0,-91
2668,1,1,1246,1361,115
2669,0,0,64,0,-64
2670,1,0,71,0,-71
2671,1,1,62,1451,1389
2672,1,0,150,0,-150
2673,1,0,40,0,-40
2674,0,0,17,0,-17
2675,1,1,105,1712,1607
2676,1,1,271,1898,1627
2677,0,0,6,0,-6
2678,0,0,17,0,-17
2679,1,0,58,0,-58
2680,1,0,55,0,-55
2681,1,1,688,1486,798
2682,1,1,275,1327,1052
2683,0,0,30,0,-30
2684,1,1,150,1680,1530
2685,1,1,598,2494,1896
2686,1,1,287,1246,959
2687,0,0,24,0,-24
2688,1,1,153,1540,1387
2689,0,0,9,0,-9
2690,1,0,39,0,-39
2691,1,0,150,0,-150
2692,1,1,342,1978,1636
2693,1,0,5,0,-5
2694,1,1,928,2428,1500
2695,1,1,345,4388,4043
2696,1,1,231,2808,2577
2697,0,0,100,0,-100
2698,1,0,14,0,-14
2699,1,1,936,2426,1490
2700,1,0,90,0,-90
2701,0,0,52,0,-52
2702,1,0,28,0,-28
2703,1,0,27,0,-27
2704,0,0,41,0,-41
2705,0,0,32,0,-32
2706,1,0,62,0,-62
2707,0,0,34,0,-34
2708,1,1,192,1297,1105
2709,0,0,91,0,-91
2710,0,0,14,0,-14
2711,0,0,93,0,-93
2712,1,1,997,1469,472
2713,1,1,836,1656,820
2714,1,0,9,0,-9
2715,1,0,11,0,-11
2716,0,0,37,0,-37
2717,0,0,28,0,-28
2718,1,1,820,1577,757
2719,1,1,354,1512,1158
2720,0,0,98,0,-98
2721,1,0,52,0,-52
2722,1,0,87,0,-87
2723,0,0,1,0,-1
2724,0,0,126,0,-126
2725,1,1,888,1578,690
2726,0,0,84,0,-84
2727,1,0,32,0,-32
2728,0,0,23,0,-23
2729,0,0,19,0,-19
2730,0,0,62,0,-62
2731,0,0,42,0,-42
2732,0,0,27,0,-27
2733,0,0,58,0,-58
2734,1,0,24,0,-24
2735,1,1,709,1501,792
2736,1,0,14,0,-14
2737,1,0,55,0,-55
2738,1,1,379,1245,866
2739,0,0,104,0,-104
2740,1,0,36,0,-36
2741,1,1,864,1238,374
2742,1,0,3,0,-3
2743,1,1,308,1249,941
2744,1,0,61,0,-61
2745,1,1,1091,1560,469
2746,0,0,43,0,-43
2747,0,0,52,0,-52
2748,1,0,6,0,-6
2749,1,1,811,1656,845
2750,0,0,37,0,-37
2751,0,0,41,0,-41
2752,1,0,73,0,-73
2753,1,1,253,1423,1170
2754,1,0,7,0,-7
2755,1,1,366,1626,1260
2756,0,0,4,0,-4
2757,1,1,3726,1241,-2485
2758,1,1,37,1629,1592
2759,0,0,30,0,-30
2760,1,0,8,0,-8
2761,0,0,19,0,-19
2762,1,1,141,1306,1165
2763,1,0,16,0,-16
2764,0,0,36,0,-36
2765,1,0,32,0,-32
2766,1,1,299,1295,996
2767,0,0,162,0,-162
2768,1,0,182,0,-182
2769,0,0,148,0,-148
2770,1,1,1149,1390,241
2771,0,0,62,0,-62
2772,0,0,6,0,-6
2773,0,0,218,0,-218
2774,1,1,179,1295,1116
2775,1,0,4,0,-4
2776,0,0,14,0,-14
2777,1,0,125,0,-125
2778,0,0,5,0,-5
2779,1,1,957,2154,1197
2780,1,0,23,0,-23
2781,1,0,11,0,-11
2782,0,0,53,0,-53
2783,1,1,73,1395,1322
2784,1,1,258,2171,1913
2785,0,0,21,0,-21
2786,0,0,36,0,-36
2787,1,0,186,0,-186
2788,1,0,27,0,-27
2789,1,1,48,3476,3428
2790,1,0,7,0,-7
2791,1,1,119,1262,1143
2792,1,0,22,0,-22
2793,0,0,11,0,-11
2794,1,0,42,0,-42
2795,0,0,61,0,-61
2796,1,0,4,0,-4
2797,1,1,656,1316,660
2798,0,0,20,0,-20
2799,1,1,1150,1356,206
2800,0,0,57,0,-57
2801,0,0,95,0,-95
2802,1,0,105,0,-105
2803,1,1,581,1331,750
2804,0,0,49,0,-49
2805,1,1,134,1493,1359
2806,1,1,1047,1647,600
2807,0,0,14,0,-14
2808,0,0,114,0,-114
2809,0,0,6,0,-6
2810,0,0,191,0,-191
2811,1,0,16,0,-16
2812,0,0,45,0,-45
2813,1,0,64,0,-64
2814,0,0,43,0,-43
2815,1,0,10,0,-10
2816,0,0,63,0,-63
2817,1,1,40,1264,1224
2818,1,1,1603,1358,-245
2819,1,0,85,0,-85
2820,1,0,33,0,-33
2821,1,0,142,0,-142
2822,1,1,714,1945,1231
2823,1,0,53,0,-53
2824,1,1,223,1826,1603
2825,1,1,313,3398,3085
2826,1,0,213,0,-213
2827,0,0,35,0,-35
2828,1,1,35,1677,1642
2829,1,0,55,0,-55
2830,0,0,46,0,-46
2831,1,1,295,1415,1120
2832,1,0,2,0,-2
2833,0,0,42,0,-42
2834,0,0,90,0,-90
2835,0,0,82,0,-82
2836,1,0,10,0,-10
2837,1,1,897,1407,510
2838,0,0,71,0,-71
2839,1,0,90,0,-90
2840,1,0,4,0,-4
2841,0,0,66,0,-66
2842,1,0,3,0,-3
2843,1,0,24,0,-24
2844,1,0,10,0,-10
2845,1,0,23,0,-23
2846,0,0,0,0,0
2847,0,0,108,0,-108
2848,1,1,411,4319,3908
2849,1,1,174,1248,1074
2850,1,1,386,1364,978
2851,0,0,108,0,-108
2852,0,0,152,0,-152
2853,1,0,59,0,-59
2854,0,0,19,0,-19
2855,1,0,0,0,0
2856,1,0,76,0,-76
2857,0,0,17,0,-17
2858,0,0,102,0,-102
2859,1,0,27,0,-27
2860,1,0,13,0,-13
2861,1,1,249,1321,1072
2862,0,0,17,0,-17
2863,0,0,4,0,-4
2864,0,0,23,0,-23
2865,1,1,334,1790,1456
2866,0,0,0,0,0
2867,0,0,79,0,-79
2868,1,1,229,1292,1063
2869,1,1,111,1526,1415
2870,0,0,39,0,-39
2871,1,0,112,0,-112
2872,0,0,26,0,-26
2873,1,1,609,1964,1355
2874,0,0,13,0,-13
2875,0,0,50,0,-50
2876,0,0,98,0,-98
2877,1,0,13,0,-13
2878,1,0,25,0,-25
2879,0,0,24,0,-24
2880,0,0,93,0,-93
2881,1,1,279,1670,1391
2882,0,0,106,0,-106
2883,1,0,57,0,-57
2884,1,1,223,1691,1468
2885,1,0,28,0,-28
2886,0,0,21,0,-21
2887,0,0,104,0,-104
2888,1,1,768,2032,1264
2889,0,0,0,0,0
2890,0,0,5,0,-5
2891,1,1,295,2609,2314
2892,1,1,8,1670,1662
2893,1,0,67,0,-67
2894,1,0,42,0,-42
2895,1,1,142,2082,1940
2896,0,0,60,0,-60
2897,0,0,16,0,-16
2898,0,0,4,0,-4
2899,0,0,62,0,-62
2900,1,1,380,1311,931
2901,1,1,79,1517,1438
2902,1,1,392,4280,3888
2903,0,0,53,0,-53
2904,1,0,120,0,-120
2905,0,0,76,0,-76
2906,1,0,14,0,-14
2907,0,0,24,0,-24
2908,1,1,367,1631,1264
2909,0,0,10,0,-10
2910,1,1,171,3176,3005
2911,0,0,224,0,-224
2912,1,1,322,1357,1035
2913,0,0,17,0,-17
2914,1,0,153,0,-153
2915,1,0,17,0,-17
2916,0,0,20,0,-20
2917,1,1,1184,1709,525
2918,1,0,48,0,-48
2919,1,0,40,0,-40
2920,0,0,98,0,-98
2921,0,0,25,0,-25
2922,1,1,337,1787,1450
2923,1,0,15,0,-15
2924,1,0,43,0,-43
2925,0,0,43,0,-43
2926,1,0,46,0,-46
2927,0,0,2,0,-2
2928,1,0,3,0,-3
2929,1,0,80,0,-80
2930,0,0,91,0,-91
2931,1,0,53,0,-53
2932,0,0,90,0,-90
2933,1,1,422,1356,934
2934,0,0,50,0,-50
2935,1,1,93,1729,1636
2936,0,0,136,0,-136
2937,1,1,900,1354,454
2938,1,1,319,1396,1077
2939,1,0,128,0,-128
2940,0,0,71,0,-71
2941,1,0,22,0,-22
2942,1,1,1361,1541,180
2943,0,0,50,0,-50
2944,0,0,26,0,-26
2945,1,1,461,1279,818
2946,0,0,40,0,-40
2947,1,1,50,1318,1268
2948,1,1,11,7649,7638
2949,1,1,2432,1433,-999
2950,0,0,103,0,-103
2951,0,0,13,0,-13
2952,0,0,6,0,-6
2953,0,0,11,0,-11
2954,0,0,25,0,-25
2955,1,0,38,0,-38
2956,1,1,46,1414,1368
2957,1,0,47,0,-47
2958,1,0,71,0,-71
2959,1,0,44,0,-44
2960,1,0,80,0,-80
2961,1,1,107,1467,1360
2962,0,0,55,0,-55
2963,1,0,70,0,-70
2964,0,0,2,0,-2
2965,1,0,7,0,-7
2966,1,1,381,1645,1264
2967,1,1,111,1299,1188
2968,1,1,159,1503,1344
2969,1,1,1002,1417,415
2970,1,1,1125,1910,785
2971,1,0,22,0,-22
2972,1,0,26,0,-26
2973,1,1,83,1370,1287
2974,1,1,815,1684,869
2975,1,0,32,0,-32
2976,0,0,5,0,-5
2977,1,1,1231,1310,79
2978,0,0,61,0,-61
2979,1,1,96,1616,1520
2980,1,0,21,0,-21
2981,1,0,22,0,-22
2982,1,1,525,1414,889
2983,1,1,286,1873,1587
2984,0,0,26,0,-26
2985,0,0,13,0,-13
2986,0,0,2,0,-2
2987,1,0,3,0,-3
2988,1,0,19,0,-19
2989,0,0,35,0,-35
2990,1,0,153,0,-153
2991,1,1,709,1443,734
2992,1,0,60,0,-60
2993,0,0,15,0,-15
2994,1,0,16,0,-16
2995,1,0,59,0,-59
2996,1,1,120,1365,1245
2997,1,1,1343,1361,18
2998,1,0,14,0,-14
2999,1,1,289,1533,1244
3000,0,0,20,0,-20
3001,1,1,1304,1528,224
3002,0,0,28,0,-28
3003,1,1,513,1319,806
3004,0,0,148,0,-148
3005,0,0,45,0,-45
3006,0,0,209,0,-209
3007,1,1,416,1455,1039
3008,0,0,26,0,-26
3009,1,0,6,0,-6
3010,0,0,16,0,-16
3011,0,0,125,0,-125
3012,1,1,420,1259,839
3013,1,1,569,1286,717
3014,1,1,647,2383,1736
3015,0,0,209,0,-209
3016,1,0,51,0,-51
3017,0,0,140,0,-140
3018,0,0,1,0,-1
3019,1,1,346,1335,989
3020,1,1,380,1300,920
3021,1,1,1142,2590,1448
3022,1,0,13,0,-13
3023,1,0,38,0,-38
3024,0,0,74,0,-74
3025,0,0,94,0,-94
3026,0,0,14,0,-14
3027,0,0,120,0,-120
3028,1,0,160,0,-160
3029,0,0,113,0,-113
3030,1,1,156,1273,1117
3031,0,0,46,0,-46
3032,1,0,31,0,-31
3033,1,0,8,0,-8
3034,1,1,616,1600,984
3035,0,0,18,0,-18
3036,1,0,94,0,-94
3037,1,0,0,0,0
3038,1,1,1743,1368,-375
3039,1,1,151,1676,1525
3040,0,0,24,0,-24
3041,1,1,223,1307,1084
3042,0,0,7,0,-7
3043,0,0,112,0,-112
3044,1,1,929,1529,600
3045,1,0,44,0,-44
3046,0,0,15,0,-15
3047,1,1,263,2083,1820
3048,0,0,24,0,-24
3049,1,0,120,0,-120
3050,1,1,632,1671,1039
3051,0,0,1,0,-1
3052,1,0,46,0,-46
3053,0,0,80,0,-80
3054,0,0,104,0,-104
3055,1,0,220,0,-220
3056,1,1,371,1295,924
3057,1,0,26,0,-26
3058,1,1,204,1692,1488
3059,1,0,92,0,-92
3060,0,0,32,0,-32
3061,0,0,1,0,-1
3062,0,0,50,0,-50
3063,0,0,2,0,-2
3064,0,0,24,0,-24
3065,1,0,1,0,-1
3066,1,1,145,1258,1113
3067,1,1,716,1362,646
3068,1,1,860,2274,1414
3069,1,1,345,1269,924
3070,1,1,317,2252,1935
3071,0,0,44,0,-44
3072,1,0,18,0,-18
3073,0,0,36,0,-36
3074,1,0,114,0,-114
3075,0,0,27,0,-27
3076,0,0,51,0,-51
3077,1,0,18,0,-18
3078,1,0,70,0,-70
3079,1,0,28,0,-28
3080,1,1,262,1514,1252
3081,1,0,88,0,-88
3082,1,0,31,0,-31
3083,1,0,21,0,-21
3084,1,0,0,0,0
3085,1,1,1166,1454,288
3086,0,0,14,0,-14
3087,1,0,10,0,-10
3088,1,0,50,0,-50
3089,1,0,10,0,-10
3090,0,0,74,0,-74
3091,0,0,15,0,-15
3092,0,0,34,0,-34
3093,1,1,80,1507,1427
3094,0,0,28,0,-28
3095,1,1,604,4988,4384
3096,0,0,3,0,-3
3097,1,1,137,1736,1599
3098,0,0,119,0,-119
3099,0,0,67,0,-67
3100,1,1,288,1918,1630
3101,1,1,590,1370,780
3102,1,0,83,0,-83
3103,1,0,40,0,-40
3104,0,0,149,0,-149
3105,0,0,48,0,-48
3106,0,0,173,0,-173
3107,1,1,131,1411,1280
3108,1,1,1202,1413,211
3109,0,0,102,0,-102
3110,1,0,13,0,-13
3111,1,1,11,1248,1237
3112,0,0,34,0,-34
3113,1,0,12,0,-12
3114,1,1,809,1350,541
3115,0,0,25,0,-25
3116,0,0,44,0,-44
3117,1,1,132,1312,1180
3118,0,0,26,0,-26
3119,0,0,47,0,-47
3120,1,1,436,1635,1199
3121,0,0,71,0,-71
3122,1,1,2273,1392,-881
3123,0,0,2,0,-2
3124,1,0,37,0,-37
3125,0,0,38,0,-38
3126,0,0,122,0,-122
3127,1,1,56,1708,1652
3128,0,0,24,0,-24
3129,1,1,164,1392,1228
3130,1,0,54,0,-54
3131,0,0,24,0,-24
3132,0,0,42,0,-42
3133,0,0,0,0,0
3134,1,0,131,0,-131
3135,0,0,21,0,-21
3136,0,0,82,0,-82
3137,0,0,106,0,-106
3138,1,0,4,0,-4
3139,1,1,714,1327,613
3140,1,1,1235,1324,89
3141,0,0,25,0,-25
3142,1,0,31,0,-31
3143,1,0,0,0,0
3144,0,0,46,0,-46
3145,1,0,172,0,-172
3146,1,1,673,1265,592
3147,1,1,1460,1283,-177
3148,1,1,1997,1276,-721
3149,1,0,22,0,-22
3150,1,1,197,1793,1596
3151,1,0,133,0,-133
3152,1,0,72,0,-72
3153,1,1,181,1371,1190
3154,1,0,18,0,-18
3155,1,0,13,0,-13
3156,1,0,28,0,-28
3157,1,1,830,1677,847
3158,1,1,85,1555,1470
3159,1,0,9,0,-9
3160,0,0,11,0,-11
3161,0,0,15,0,-15
3162,1,0,62,0,-62
3163,0,0,1,0,-1
3164,0,0,74,0,-74
3165,1,0,150,0,-150
3166,1,0,85,0,-85
3167,1,1,466,1370,904
3168,1,0,8,0,-8
3169,0,0,36,0,-36
3170,0,0,57,0,-57
3171,1,1,40,1265,1225
3172,1,0,8,0,-8
3173,1,1,77,3742,3665
3174,1,0,74,0,-74
3175,0,0,88,0,-88
3176,1,0,27,0,-27
3177,1,0,214,0,-214
3178,1,0,137,0,-137
3179,0,0,9,0,-9
3180,0,0,72,0,-72
3181,1,1,1202,1506,304
3182,1,0,61,0,-61
3183,0,0,4,0,-4
3184,0,0,1,0,-1
3185,1,0,130,0,-130
3186,1,0,95,0,-95
3187,0,0,7,0,-7
3188,1,0,7,0,-7
3189,1,0,1,0,-1
3190,1,0,186,0,-186
3191,1,1,81,1455,1374
3192,1,1,107,1837,1730
3193,0,0,3,0,-3
3194,1,0,35,0,-35
3195,1,1,214,3972,3758
3196,1,0,208,0,-208
3197,0,0,3,0,-3
3198,1,1,206,1527,1321
3199,0,0,93,0,-93
3200,0,0,2,0,-2
3201,1,1,222,1318,1096
3202,1,1,675,3016,2341
3203,1,1,1816,3284,1468
3204,1,0,33,0,-33
3205,1,1,706,1432,726
3206,0,0,118,0,-118
3207,0,0,84,0,-84
3208,1,1,223,1438,1215
3209,1,0,11,0,-11
3210,0,0,10,0,-10
3211,1,1,287,1241,954
3212,0,0,144,0,-144
3213,0,0,19,0,-19
3214,1,0,99,0,-99
3215,1,1,388,1303,915
3216,0,0,125,0,-125
3217,0,0,2,0,-2
3218,1,0,142,0,-142
3219,1,1,205,1748,1543
3220,0,0,110,0,-110
3221,1,1,318,1244,926
3222,0,0,4,0,-4
3223,0,0,1,0,-1
3224,0,0,150,0,-150
3225,0,0,21,0,-21
3226,1,1,778,1816,1038
3227,1,0,1,0,-1
3228,1,1,50,1835,1785
3229,1,1,910,2011,1101
3230,1,0,27,0,-27
3231,0,0,122,0,-122
3232,1,0,72,0,-72
3233,1,0,98,0,-98
3234,0,0,24,0,-24
3235,0,0,6,0,-6
3236,1,1,870,1907,1037
3237,1,1,925,1523,598
3238,1,1,446,1369,923
3239,0,0,41,0,-41
3240,0,0,8,0,-8
3241,1,0,117,0,-117
3242,0,0,27,0,-27
3243,1,0,20,0,-20
3244,0,0,52,0,-52
3245,0,0,53,0,-53
3246,1,1,354,1454,1100
3247,1,0,23,0,-23
3248,1,1,441,1363,922
3249,0,0,36,0,-36
3250,0,0,4,0,-4
3251,0,0,42,0,-42
3252,1,1,162,1554,1392
3253,0,0,11,0,-11
3254,0,0,46,0,-46
3255,0,0,255,0,-255
3256,1,0,62,0,-62
3257,1,1,867,1309,442
3258,1,1,302,1466,1164
3259,1,1,413,1260,847
3260,0,0,1,0,-1
3261,0,0,14,0,-14
3262,1,1,114,6082,5968
3263,1,1,209,1364,1155
3264,0,0,12,0,-12
3265,0,0,26,0,-26
3266,0,0,65,0,-65
3267,1,0,48,0,-48
3268,0,0,93,0,-93
3269,1,0,4,0,-4
3270,0,0,11,0,-11
3271,0,0,126,0,-126
3272,1,0,23,0,-23
3273,0,0,132,0,-132
3274,1,0,90,0,-90
3275,1,1,687,2430,1743
3276,1,0,6,0,-6
3277,1,1,140,1816,1676
3278,1,1,269,1633,1364
3279,0,0,15,0,-15
3280,1,1,478,1393,915
3281,1,0,190,0,-190
3282,1,0,112,0,-112
3283,1,1,578,1540,962
3284,1,1,124,1432,1308
3285,1,1,42,1628,1586
3286,1,1,356,1274,918
3287,1,1,502,1304,802
3288,0,0,14,0,-14
3289,1,0,62,0,-62
3290,1,1,323,1306,983
3291,1,0,10,0,-10
3292,1,0,66,0,-66
3293,1,1,693,1499,806
3294,1,1,119,1964,1845
3295,1,1,1400,1337,-63
3296,0,0,43,0,-43
3297,0,0,11,0,-11
3298,1,1,223,1308,1085
3299,1,0,27,0,-27
3300,1,0,8,0,-8
3301,1,1,1089,1773,684
3302,0,0,71,0,-71
3303,1,1,193,1379,1186
3304,0,0,21,0,-21
3305,0,0,78,0,-78
3306,0,0,10,0,-10
3307,0,0,25,0,-25
3308,1,1,1499,1396,-103
3309,1,0,39,0,-39
3310,0,0,4,0,-4
3311,1,0,14,0,-14
3312,1,0,4,0,-4
3313,1,0,95,0,-95
3314,0,0,61,0,-61
3315,1,1,498,1718,1220
3316,0,0,109,0,-109
3317,0,0,11,0,-11
3318,1,1,203,1417,1214
3319,0,0,0,0,0
3320,0,0,127,0,-127
3321,1,1,196,1246,1050
3322,0,0,24,0,-24
3323,0,0,48,0,-48
3324,0,0,45,0,-45
3325,1,1,526,1907,1381
3326,0,0,15,0,-15
3327,0,0,48,0,-48
3328,1,0,70,0,-70
3329,1,1,87,1569,1482
3330,0,0,9,0,-9
3331,1,0,41,0,-41
3332,1,0,11,0,-11
3333,1,0,29,0,-29
3334,1,1,741,1288,547
3335,1,0,20,0,-20
3336,0,0,1,0,-1
3337,1,0,31,0,-31
3338,1,0,26,0,-26
3339,1,0,70,0,-70
3340,1,1,347,2030,1683
3341,0,0,87,0,-87
3342,0,0,15,0,-15
3343,1,0,85,0,-85
3344,1,1,339,1341,1002
3345,1,0,23,0,-23
3346,1,1,180,1359,1179
3347,1,1,1180,1782,602
3348,0,0,2,0,-2
3349,1,0,54,0,-54
3350,0,0,8,0,-8
3351,1,0,14,0,-14
3352,1,0,55,0,-55
3353,0,0,30,0,-30
3354,0,0,197,0,-197
3355,1,0,67,0,-67
3356,1,0,233,0,-233
3357,1,0,36,0,-36
3358,1,1,708,1991,1283
3359,0,0,119,0,-119
3360,1,0,115,0,-115
3361,0,0,75,0,-75
3362,1,0,24,0,-24
3363,0,0,66,0,-66
3364,1,0,104,0,-104
3365,1,1,173,1534,1361
3366,0,0,36,0,-36
3367,0,0,12,0,-12
3368,0,0,28,0,-28
3369,1,0,55,0,-55
3370,0,0,6,0,-6
3371,1,1,795,2598,1803
3372,0,0,40,0,-40
3373,1,0,3,0,-3
3374,0,0,143,0,-143
3375,1,0,39,0,-39
3376,0,0,6,0,-6
3377,1,0,71,0,-71
3378,0,0,128,0,-128
3379,1,0,28,0,-28
3380,1,0,26,0,-26
3381,0,0,83,0,-83
3382,0,0,47,0,-47
3383,1,0,13,0,-13
3384,1,0,123,0,-123
3385,1,1,205,1286,1081
3386,1,1,354,1734,1380
3387,1,1,131,1241,1110
3388,1,1,636,3891,3255
3389,1,0,2,0,-2
3390,0,0,96,0,-96
3391,1,0,47,0,-47
3392,1,1,171,2263,2092
3393,0,0,20,0,-20
3394,1,1,203,1691,1488
3395,0,0,70,0,-70
3396,0,0,29,0,-29
3397,0,0,19,0,-19
3398,0,0,106,0,-106
3399,0,0,72,0,-72
3400,0,0,22,0,-22
3401,1,1,211,2162,1951
3402,1,1,445,1384,939
3403,0,0,38,0,-38
3404,0,0,2,0,-2
3405,0,0,21,0,-21
3406,1,1,816,1276,460
3407,1,1,352,1324,972
3408,1,1,628,1459,831
3409,0,0,44,0,-44
3410,1,0,6,0,-6
3411,1,1,1831,1336,-495
3412,0,0,2,0,-2
3413,1,1,55,1237,1182
3414,0,0,134,0,-134
3415,1,1,314,1308,994
3416,1,0,28,0,-28
3417,0,0,27,0,-27
3418,1,0,136,0,-136
3419,1,1,922,1332,410
3420,1,1,372,1870,1498
3421,0,0,2,0,-2
3422,1,0,99,0,-99
3423,1,1,719,1363,644
3424,0,0,29,0,-29
3425,0,0,31,0,-31
3426,1,1,249,1298,1049
3427,1,0,52,0,-52
3428,0,0,1,0,-1
3429,1,1,99,5103,5004
3430,1,1,260,1537,1277
3431,1,1,291,1256,965
3432,1,1,602,1429,827
3433,1,1,593,1925,1332
3434,1,1,215,1286,1071
3435,1,1,743,1708,965
3436,1,1,174,1631,1457
3437,1,0,122,0,-122
3438,0,0,9,0,-9
3439,1,1,1116,1344,228
3440,1,1,748,1282,534
3441,1,0,15,0,-15
3442,0,0,20,0,-20
3443,1,0,73,0,-73
3444,1,1,327,1622,1295
3445,0,0,5,0,-5
3446,1,0,8,0,-8
3447,0,0,61,0,-61
3448,0,0,4,0,-4
3449,1,0,65,0,-65
3450,0,0,16,0,-16
3451,1,0,8,0,-8
3452,0,0,61,0,-61
3453,1,1,688,1551,863
3454,1,0,131,0,-131
3455,0,0,19,0,-19
3456,1,1,266,1271,1005
3457,0,0,8,0,-8
3458,1,1,2909,1597,-1312
3459,0,0,52,0,-52
3460,0,0,4,0,-4
3461,1,0,167,0,-167
3462,1,0,22,0,-22
3463,0,0,19,0,-19
3464,1,0,8,0,-8
3465,0,0,12,0,-12
3466,1,1,356,4345,3989
3467,1,1,302,1284,982
3468,1,0,97,0,-97
3469,1,0,12,0,-12
3470,0,0,36,0,-36
3471,0,0,55,0,-55
3472,1,1,635,1636,1001
3473,1,0,48,0,-48
3474,0,0,25,0,-25
3475,1,1,1571,1283,-288
3476,0,0,26,0,-26
3477,1,1,249,1255,1006
3478,0,0,0,0,0
3479,1,0,8,0,-8
3480,0,0,134,0,-134
3481,0,0,127,0,-127
3482,1,1,138,1655,1517
3483,1,0,40,0,-40
3484,1,1,138,1306,1168
3485,0,0,60,0,-60
3486,0,0,88,0,-88
3487,1,1,156,1839,1683
3488,0,0,4,0,-4
3489,1,1,240,1355,1115
3490,1,0,3,0,-3
3491,0,0,73,0,-73
3492,1,0,81,0,-81
3493,1,1,172,1728,1556
3494,0,0,2,0,-2
3495,1,0,5,0,-5
3496,0,0,51,0,-51
3497,0,0,34,0,-34
3498,0,0,72,0,-72
3499,1,1,314,2422,2108
3500,1,0,2,0,-2
3501,0,0,41,0,-41
3502,1,0,43,0,-43
3503,0,0,40,0,-40
3504,1,1,242,1684,1442
3505,1,0,0,0,0
3506,1,1,288,1675,1387
3507,0,0,62,0,-62
3508,1,1,267,2188,1921
3509,1,1,529,1239,710
3510,1,0,21,0,-21
3511,0,0,49,0,-49
3512,0,0,34,0,-34
3513,1,0,31,0,-31
3514,1,0,181,0,-181
3515,0,0,97,0,-97
3516,1,1,316,1495,1179
3517,0,0,65,0,-65
3518,1,1,42,1537,1495
3519,1,0,71,0,-71
3520,1,0,76,0,-76
3521,0,0,22,0,-22
3522,1,1,632,2994,2362
3523,1,1,1274,1307,33
3524,1,0,57,0,-57
3525,1,0,32,0,-32
3526,1,1,594,1740,1146
3527,1,1,60,1440,1380
3528,1,1,846,2811,1965
3529,1,0,53,0,-53
3530,1,1,309,1484,1175
3531,1,1,547,2162,1615
3532,1,0,55,0,-55
3533,1,1,65,1395,1330
3534,1,1,1396,2675,1279
3535,1,0,68,0,-68
3536,1,1,520,1294,774
3537,1,1,974,1826,852
3538,0,0,45,0,-45
3539,1,0,40,0,-40
3540,1,0,42,0,-42
3541,0,0,90,0,-90
3542,1,1,60,1260,1200
3543,0,0,14,0,-14
3544,0,0,37,0,-37
3545,0,0,8,0,-8
3546,0,0,20,0,-20
3547,0,0,22,0,-22
3548,1,0,6,0,-6
3549,0,0,4,0,-4
3550,0,0,45,0,-45
3551,0,0,3,0,-3
3552,1,0,24,0,-24
3553,0,0,25,0,-25
3554,1,0,28,0,-28
3555,0,0,15,0,-15
3556,0,0,15,0,-15
3557,1,0,42,0,-42
3558,1,1,381,1250,869
3559,1,1,492,1635,1143
3560,1,0,47,0,-47
3561,1,0,0,0,0
3562,0,0,50,0,-50
3563,1,0,2,0,-2
3564,1,0,43,0,-43
3565,0,0,3,0,-3
3566,0,0,20,0,-20
3567,1,1,1231,3155,1924
3568,0,0,86,0,-86
3569,1,0,25,0,-25
3570,1,1,167,2362,2195
3571,1,0,12,0,-12
3572,1,1,991,1372,381
3573,0,0,19,0,-19
3574,0,0,48,0,-48
3575,0,0,14,0,-14
3576,0,0,40,0,-40
3577,1,0,69,0,-69
3578,1,1,187,1762,1575
3579,1,0,31,0,-31
3580,0,0,46,0,-46
3581,1,1,72,1517,1445
3582,1,0,4,0,-4
3583,1,0,73,0,-73
3584,1,1,1042,1292,250
3585,0,0,18,0,-18
3586,0,0,62,0,-62
3587,1,0,51,0,-51
3588,1,1,132,1497,1365
3589,1,1,573,1376,803
3590,0,0,4,0,-4
3591,1,1,230,1254,1024
3592,0,0,0,0,0
3593,0,0,71,0,-71
3594,0,0,38,0,-38
3595,0,0,8,0,-8
3596,1,1,93,1381,1288
3597,0,0,10,0,-10
3598,1,1,1462,1596,134
3599,0,0,12,0,-12
3600,1,0,15,0,-15
3601,1,0,49,0,-49
3602,0,0,75,0,-75
3603,1,0,85,0,-85
3604,1,1,543,1311,768
3605,1,1,523,1314,791
3606,1,0,46,0,-46
3607,1,0,1,0,-1
3608,0,0,3,0,-3
3609,0,0,57,0,-57
3610,1,0,22,0,-22
3611,1,1,690,1671,981
3612,1,1,1049,1267,218
3613,1,0,6,0,-6
3614,0,0,54,0,-54
3615,1,0,12,0,-12
3616,0,0,28,0,-28
3617,0,0,54,0,-54
3618,1,0,97,0,-97
3619,1,0,93,0,-93
3620,1,1,1907,1430,-477
3621,1,1,255,1484,1229
3622,1,1,567,1314,747
3623,0,0,58,0,-58
3624,1,0,138,0,-138
3625,0,0,56,0,-56
3626,0,0,34,0,-34
3627,1,0,0,0,0
3628,1,1,354,1299,945
3629,0,0,107,0,-107
3630,0,0,35,0,-35
3631,1,1,475,1806,1331
3632,1,0,40,0,-40
3633,0,0,15,0,-15
3634,0,0,5,0,-5
3635,0,0,6,0,-6
3636,0,0,101,0,-101
3637,1,0,3,0,-3
3638,1,1,269,1285,1016
3639,1,1,385,1928,1543
3640,0,0,77,0,-77
3641,0,0,14,0,-14
3642,1,0,33,0,-33
3643,0,0,14,0,-14
3644,1,0,3,0,-3
3645,1,1,627,1301,674
3646,1,1,485,3042,2557
3647,1,0,33,0,-33
3648,0,0,165,0,-165
3649,0,0,2,0,-2
3650,1,1,100,1901,1801
3651,0,0,197,0,-197
3652,1,1,515,2270,1755
3653,1,1,544,1965,1421
3654,0,0,106,0,-106
3655,1,1,115,1246,1131
3656,0,0,57,0,-57
3657,1,0,1,0,-1
3658,1,1,324,1566,1242
3659,0,0,32,0,-32
3660,1,0,141,0,-141
3661,0,0,1,0,-1
3662,1,0,27,0,-27
3663,0,0,29,0,-29
3664,1,1,1212,1373,161
3665,1,0,109,0,-109
3666,0,0,6,0,-6
3667,1,1,1685,2041,356
3668,1,1,285,1333,1048
3669,0,0,34,0,-34
3670,0,0,20,0,-20
3671,1,0,178,0,-178
3672,0,0,38,0,-38
3673,1,1,280,1706,1426
3674,1,0,63,0,-63
3675,0,0,70,0,-70
3676,0,0,79,0,-79
3677,0,0,36,0,-36
3678,1,0,7,0,-7
3679,0,0,8,0,-8
3680,1,1,110,1651,1541
3681,0,0,32,0,-32
3682,0,0,42,0,-42
3683,0,0,79,0,-79
3684,0,0,16,0,-16
3685,1,0,71,0,-71
3686,0,0,22,0,-22
3687,0,0,170,0,-170
3688,0,0,24,0,-24
3689,0,0,32,0,-32
3690,1,0,39,0,-39
3691,1,0,32,0,-32
3692,1,1,385,1975,1590
3693,1,0,82,0,-82
3694,0,0,14,0,-14
3695,0,0,204,0,-204
3696,1,1,320,1235,915
3697,1,1,266,2109,1843
3698,0,0,46,0,-46
3699,0,0,88,0,-88
3700,1,0,58,0,-58
3701,1,0,4,0,-4
3702,1,0,29,0,-29
3703,1,1,175,1920,1745
3704,1,1,587,1435,848
3705,0,0,0,0,0
3706,1,1,346,2563,2217
3707,0,0,26,0,-26
3708,1,1,129,1630,1501
3709,1,0,5,0,-5
3710,0,0,4,0,-4
3711,1,1,746,1355,609
3712,1,0,132,0,-132
3713,0,0,80,0,-80
3714,1,0,32,0,-32
3715,0,0,27,0,-27
3716,1,1,514,1871,1357
3717,1,1,1383,1842,459
3718,1,0,53,0,-53
3719,0,0,0,0,0
3720,1,0,94,0,-94
3721,0,0,3,0,-3
3722,1,0,32,0,-32
3723,1,0,26,0,-26
3724,1,0,2,0,-2
3725,1,1,767,1256,489
3726,1,1,1689,3747,2058
3727,1,0,1,0,-1
3728,1,0,15,0,-15
3729,0,0,33,0,-33
3730,0,0,6,0,-6
3731,1,0,78,0,-78
3732,1,1,250,1368,1118
3733,1,0,186,0,-186
3734,1,0,0,0,0
3735,1,0,122,0,-122
3736,0,0,5,0,-5
3737,0,0,17,0,-17
3738,1,0,21,0,-21
3739,0,0,60,0,-60
3740,1,0,27,0,-27
3741,1,0,15,0,-15
3742,1,1,222,2162,1940
3743,0,0,1,0,-1
3744,1,0,24,0,-24
3745,1,0,25,0,-25
3746,0,0,49,0,-49
3747,1,1,394,1464,1070
3748,1,0,26,0,-26
3749,1,1,1109,1329,220
3750,1,1,477,1504,1027
3751,1,0,88,0,-88
3752,1,0,35,0,-35
3753,0,0,12,0,-12
3754,0,0,48,0,-48
3755,1,1,349,1384,1035
3756,1,0,83,0,-83
3757,1,1,212,1339,1127
3758,0,0,8,0,-8
3759,1,0,122,0,-122
3760,0,0,46,0,-46
3761,1,0,66,0,-66
3762,1,0,1,0,-1
3763,0,0,257,0,-257
3764,1,1,1068,1242,174
3765,1,1,894,1296,402
3766,1,1,550,1321,771
3767,1,0,57,0,-57
3768,1,1,278,1350,1072
3769,1,0,6,0,-6
3770,1,1,259,1373,1114
3771,1,1,666,1327,661
3772,0,0,41,0,-41
3773,0,0,36,0,-36
3774,1,0,33,0,-33
3775,1,0,42,0,-42
3776,0,0,4,0,-4
3777,0,0,8,0,-8
3778,1,1,1251,1452,201
3779,1,0,33,0,-33
3780,1,1,787,1337,550
3781,1,1,378,1438,1060
3782,0,0,124,0,-124
3783,0,0,31,0,-31
3784,0,0,3,0,-3
3785,1,1,605,1268,663
3786,1,1,1669,1267,-402
3787,1,0,18,0,-18
3788,0,0,23,0,-23
3789,0,0,7,0,-7
3790,1,1,611,1724,1113
3791,1,0,9,0,-9
3792,1,0,0,0,0
3793,0,0,81,0,-81
3794,0,0,42,0,-42
3795,1,1,91,1524,1433
3796,1,1,76,1262,1186
3797,0,0,26,0,-26
3798,0,0,14,0,-14
3799,1,0,83,0,-83
3800,1,1,431,1817,1386
3801,0,0,51,0,-51
3802,1,1,603,3007,2404
3803,1,0,16,0,-16
3804,0,0,9,0,-9
3805,1,0,41,0,-41
3806,0,0,32,0,-32
3807,0,0,65,0,-65
3808,1,0,23,0,-23
3809,0,0,29,0,-29
3810,1,1,695,1272,577
3811,1,0,56,0,-56
3812,0,0,122,0,-122
3813,0,0,77,0,-77
3814,1,1,280,1265,985
3815,0,0,24,0,-24
3816,0,0,94,0,-94
3817,1,1,354,1295,941
3818,1,1,185,1545,1360
3819,1,1,489,1671,1182
3820,1,0,102,0,-102
3821,0,0,16,0,-16
3822,0,0,76,0,-76
3823,1,1,661,2141,1480
3824,1,1,157,1785,1628
3825,1,0,102,0,-102
3826,0,0,35,0,-35
3827,0,0,32,0,-32
3828,0,0,3,0,-3
3829,1,1,720,1441,721
3830,0,0,118,0,-118
3831,1,1,1251,1555,304
3832,0,0,59,0,-59
3833,0,0,41,0,-41
3834,1,1,804,2802,1998
3835,0,0,106,0,-106
3836,0,0,87,0,-87
3837,1,0,0,0,0
3838,1,0,21,0,-21
3839,1,0,98,0,-98
3840,0,0,84,0,-84
3841,0,0,43,0,-43
3842,0,0,29,0,-29
3843,1,1,81,1350,1269
3844,1,0,11,0,-11
3845,0,0,47,0,-47
3846,0,0,7,0,-7
3847,1,1,605,3931,3326
3848,1,0,5,0,-5
3849,0,0,23,0,-23
3850,0,0,37,0,-37
3851,0,0,9,0,-9
3852,0,0,22,0,-22
3853,1,0,117,0,-117
3854,1,0,29,0,-29
3855,1,1,74,1971,1897
3856,1,1,127,1978,1851
3857,0,0,12,0,-12
3858,1,1,76,1313,1237
3859,1,1,863,1248,385
3860,1,0,12,0,-12
3861,0,0,6,0,-6
3862,0,0,37,0,-37
3863,0,0,222,0,-222
3864,0,0,7,0,-7
3865,1,1,1446,1258,-188
3866,1,1,695,3302,2607
3867,1,0,88,0,-88
3868,1,1,849,1903,1054
3869,1,0,10,0,-10
3870,1,0,13,0,-13
3871,1,0,44,0,-44
3872,1,1,376,1305,929
3873,0,0,1,0,-1
3874,1,1,168,1682,1514
3875,1,1,58,9486,9428
3876,1,1,363,1419,1056
3877,1,0,51,0,-51
3878,1,1,130,1341,1211
3879,1,0,67,0,-67
3880,1,1,1305,1245,-60
3881,0,0,162,0,-162
3882,1,0,24,0,-24
3883,0,0,5,0,-5
3884,0,0,168,0,-168
3885,0,0,80,0,-80
3886,1,0,44,0,-44
3887,1,0,0,0,0
3888,1,1,230,1514,1284
3889,1,1,125,2608,2483
3890,0,0,93,0,-93
3891,0,0,39,0,-39
3892,1,0,54,0,-54
3893,0,0,34,0,-34
3894,0,0,20,0,-20
3895,0,0,21,0,-21
3896,0,0,52,0,-52
3897,1,1,566,1575,1009
3898,1,0,49,0,-49
3899,1,0,92,0,-92
3900,1,0,60,0,-60
3901,0,0,44,0,-44
3902,1,1,1371,2105,734
3903,0,0,75,0,-75
3904,1,1,1216,1594,378
3905,1,0,26,0,-26
3906,1,0,8,0,-8
3907,0,0,6,0,-6
3908,1,1,292,1425,1133
3909,1,0,35,0,-35
3910,0,0,44,0,-44
3911,1,1,162,1523,1361
3912,1,0,201,0,-201
3913,0,0,110,0,-110
3914,0,0,105,0,-105
3915,1,1,1031,1469,438
3916,0,0,46,0,-46
3917,0,0,10,0,-10
3918,0,0,42,0,-42
3919,0,0,13,0,-13
3920,1,0,189,0,-189
3921,1,1,971,1412,441
3922,0,0,101,0,-101
3923,1,1,106,1446,1340
3924,1,0,10,0,-10
3925,0,0,31,0,-31
3926,1,0,31,0,-31
3927,1,1,671,1829,1158
3928,1,0,11,0,-11
3929,0,0,7,0,-7
3930,0,0,36,0,-36
3931,0,0,71,0,-71
3932,1,1,168,2646,2478
3933,1,0,40,0,-40
3934,0,0,71,0,-71
3935,1,0,28,0,-28
3936,1,1,640,1443,803
3937,1,0,45,0,-45
3938,0,0,77,0,-77
3939,1,0,88,0,-88
3940,1,1,96,1348,1252
3941,1,1,549,1474,925
3942,1,0,9,0,-9
3943,1,0,212,0,-212
3944,1,1,638,3225,2587
3945,1,1,1152,1484,332
3946,1,0,35,0,-35
3947,0,0,144,0,-144
3948,1,0,99,0,-99
3949,0,0,170,0,-170
3950,0,0,4,0,-4
3951,1,0,92,0,-92
3952,1,1,1135,1671,536
3953,1,0,2,0,-2
3954,1,0,45,0,-45
3955,1,1,429,1577,1148
3956,0,0,50,0,-50
3957,1,1,361,2026,1665
3958,0,0,6,0,-6
3959,1,1,121,1404,1283
3960,0,0,7,0,-7
3961,0,0,112,0,-112
3962,0,0,8,0,-8
3963,1,1,223,1572,1349
3964,1,0,41,0,-41
3965,1,1,97,1581,1484
3966,0,0,3,0,-3
3967,1,0,0,0,0
3968,1,0,20,0,-20
3969,1,1,1046,4215,3169
3970,0,0,3,0,-3
3971,0,0,5,0,-5
3972,1,1,345,1377,1032
3973,1,0,18,0,-18
3974,1,0,150,0,-150
3975,1,0,21,0,-21
3976,0,0,16,0,-16
3977,0,0,115,0,-115
3978,1,1,31,1259,1228
3979,1,1,55,1978,1923
3980,1,0,44,0,-44
3981,0,0,43,0,-43
3982,0,0,55,0,-55
3983,1,0,53,0,-53
3984,1,0,57,0,-57
3985,0,0,156,0,-156
3986,1,1,21,3175,3154
3987,1,0,8,0,-8
3988,1,0,7,0,-7
3989,1,1,87,1367,1280
3990,1,0,34,0,-34
3991,1,1,158,1693,1535
3992,0,0,37,0,-37
3993,0,0,43,0,-43
3994,1,1,223,1534,1311
3995,1,0,1,0,-1
3996,0,0,0,0,0
3997,1,1,102,1251,1149
3998,1,1,556,1393,837
3999,1,1,602,1594,992
4000,1,1,635,1266,631
4001,0,0,28,0,-28
4002,1,1,335,1649,1314
4003,1,0,48,0,-48
4004,1,1,520,2293,1773
4005,1,0,32,0,-32
4006,1,1,78,2670,2592
4007,1,0,94,0,-94
4008,0,0,28,0,-28
4009,0,0,19,0,-19
4010,1,0,1,0,-1
4011,0,0,39,0,-39
4012,1,0,6,0,-6
4013,1,0,217,0,-217
4014,0,0,98,0,-98
4015,1,1,1301,1366,65
4016,0,0,53,0,-53
4017,1,0,36,0,-36
4018,0,0,103,0,-103
4019,1,1,416,1247,831
4020,1,0,82,0,-82
4021,1,0,18,0,-18
4022,0,0,2,0,-2
4023,1,1,241,1290,1049
4024,1,1,622,1474,852
4025,0,0,17,0,-17
4026,1,1,1926,2086,160
4027,1,1,1307,1689,382
4028,1,1,101,1237,1136
4029,0,0,118,0,-118
4030,0,0,112,0,-112
4031,1,1,126,1936,1810
4032,1,1,275,1417,1142
4033,1,0,64,0,-64
4034,0,0,3,0,-3
4035,0,0,10,0,-10
4036,1,1,97,1725,1628
4037,1,1,789,1268,479
4038,1,0,168,0,-168
4039,1,0,24,0,-24
4040,1,0,42,0,-42
4041,1,1,297,1323,1026
4042,0,0,110,0,-110
4043,0,0,56,0,-56
4044,1,0,37,0,-37
4045,0,0,3,0,-3
4046,1,0,105,0,-105
4047,0,0,96,0,-96
4048,0,0,116,0,-116
4049,0,0,28,0,-28
4050,1,1,661,1413,752
4051,1,0,5,0,-5
4052,1,0,109,0,-109
4053,1,0,6,0,-6
4054,1,0,17,0,-17
4055,1,1,568,1628,1060
4056,0,0,3,0,-3
4057,0,0,5,0,-5
4058,1,0,20,0,-20
4059,1,0,75,0,-75
4060,0,0,20,0,-20
4061,1,1,446,1481,1035
4062,0,0,24,0,-24
4063,1,0,25,0,-25
4064,1,0,86,0,-86
4065,1,1,395,1457,1062
4066,1,1,1259,1702,443
4067,1,1,219,3568,3349
4068,1,1,1703,1490,-213
4069,1,1,191,2036,1845
4070,1,1,551,1415,864
4071,1,1,294,2382,2088
4072,1,1,406,1375,969
4073,1,0,7,0,-7
4074,1,1,70,2188,2118
4075,1,0,115,0,-115
4076,0,0,12,0,-12
4077,1,1,1158,1618,460
4078,1,0,50,0,-50
4079,0,0,57,0,-57
4080,0,0,23,0,-23
4081,1,1,801,1666,865
4082,1,1,290,1382,1092
4083,1,0,47,0,-47
4084,1,0,12,0,-12
4085,1,1,425,1430,1005
4086,1,1,101,1524,1423
4087,0,0,17,0,-17
4088,1,1,216,2126,1910
4089,0,0,2,0,-2
4090,1,1,398,1451,1053
4091,1,0,12,0,-12
4092,1,0,39,0,-39
4093,1,1,1530,1507,-23
4094,1,1,2513,1507,-1006
4095,0,0,78,0,-78
4096,0,0,172,0,-172
4097,1,0,42,0,-42
4098,0,0,77,0,-77
4099,0,0,19,0,-19
4100,0,0,103,0,-103
4101,0,0,13,0,-13
4102,0,0,59,0,-59
4103,1,1,196,1517,1321
4104,0,0,70,0,-70
4105,1,1,63,2294,2231
4106,1,0,83,0,-83
4107,1,1,903,2472,1569
4108,0,0,156,0,-156
4109,1,0,0,0,0
4110,0,0,16,0,-16
4111,0,0,24,0,-24
4112,1,1,478,1341,863
4113,1,1,1137,1408,271
4114,0,0,49,0,-49
4115,0,0,39,0,-39
4116,1,0,86,0,-86
4117,0,0,44,0,-44
4118,0,0,30,0,-30
4119,1,1,132,1590,1458
4120,0,0,16,0,-16
4121,1,0,9,0,-9
4122,1,0,26,0,-26
4123,1,0,59,0,-59
4124,1,0,104,0,-104
4125,1,0,55,0,-55
4126,0,0,25,0,-25
4127,0,0,7,0,-7
4128,1,1,221,2273,2052
4129,0,0,26,0,-26
4130,0,0,2,0,-2
4131,0,0,66,0,-66
4132,0,0,155,0,-155
4133,0,0,10,0,-10
4134,0,0,1,0,-1
4135,0,0,7,0,-7
4136,1,1,498,2369,1871
4137,1,1,147,1520,1373
4138,1,0,81,0,-81
4139,0,0,0,0,0
4140,0,0,82,0,-82
4141,1,0,175,0,-175
4142,1,1,81,1427,1346
4143,1,1,1281,1247,-34
4144,1,0,75,0,-75
4145,1,0,121,0,-121
4146,0,0,59,0,-59
4147,0,0,3,0,-3
4148,1,1,1626,1939,313
4149,1,1,193,1724,1531
4150,0,0,44,0,-44
4151,1,0,226,0,-226
4152,0,0,75,0,-75
4153,1,0,1,0,-1
4154,1,1,666,1375,709
4155,1,0,8,0,-8
4156,0,0,99,0,-99
4157,1,0,16,0,-16
4158,0,0,20,0,-20
4159,1,0,117,0,-117
4160,1,1,242,1728,1486
4161,1,1,84,1381,1297
4162,0,0,9,0,-9
4163,1,1,531,1289,758
4164,0,0,178,0,-178
4165,0,0,100,0,-100
4166,1,0,45,0,-45
4167,0,0,49,0,-49
4168,0,0,35,0,-35
4169,1,0,107,0,-107
4170,0,0,14,0,-14
4171,0,0,54,0,-54
4172,1,1,261,1919,1658
4173,1,0,19,0,-19
4174,1,0,61,0,-61
4175,0,0,82,0,-82
4176,1,1,152,1285,1133
4177,1,0,29,0,-29
4178,1,1,60,3482,3422
4179,0,0,22,0,-22
4180,1,1,2735,1239,-1496
4181,1,1,1646,1476,-170
4182,1,1,1352,1467,115
4183,1,0,13,0,-13
4184,0,0,25,0,-25
4185,0,0,118,0,-118
4186,1,1,317,3054,2737
4187,1,0,15,0,-15
4188,1,0,4,0,-4
4189,0,0,164,0,-164
4190,1,1,1126,1379,253
4191,1,1,261,1515,1254
4192,1,1,631,1398,767
4193,0,0,128,0,-128
4194,1,1,344,1313,969
4195,0,0,26,0,-26
4196,1,0,44,0,-44
4197,1,1,410,1313,903
4198,1,0,9,0,-9
4199,1,1,747,1392,645
4200,1,0,81,0,-81
4201,1,1,1530,1299,-231
4202,0,0,95,0,-95
4203,1,1,1734,1398,-336
4204,1,1,293,1311,1018
4205,0,0,43,0,-43
4206,1,1,449,1291,842
4207,0,0,17,0,-17
4208,1,1,601,1283,682
4209,1,1,207,1235,1028
4210,1,0,7,0,-7
4211,0,0,8,0,-8
4212,0,0,3,0,-3
4213,1,1,757,1309,552
4214,1,0,22,0,-22
4215,0,0,98,0,-98
4216,1,1,793,1865,1072
4217,0,0,35,0,-35
4218,1,0,108,0,-108
4219,0,0,9,0,-9
4220,1,1,972,1692,720
4221,0,0,84,0,-84
4222,1,0,3,0,-3
4223,0,0,33,0,-33
4224,1,0,93,0,-93
4225,0,0,29,0,-29
4226,1,0,43,0,-43
4227,1,1,375,1508,1133
4228,0,0,91,0,-91
4229,1,0,30,0,-30
4230,1,1,955,1951,996
4231,0,0,133,0,-133
4232,0,0,74,0,-74
4233,1,1,579,1729,1150
4234,1,0,36,0,-36
4235,1,1,815,1243,428
4236,1,0,98,0,-98
4237,1,1,1045,1305,260
4238,1,1,277,1741,1464
4239,1,0,13,0,-13
4240,1,1,1265,2646,1381
4241,1,0,66,0,-66
4242,1,1,1035,1527,492
4243,0,0,103,0,-103
4244,0,0,60,0,-60
4245,0,0,7,0,-7
4246,1,1,80,1250,1170
4247,0,0,3,0,-3
4248,0,0,39,0,-39
4249,1,1,1104,1338,234
4250,1,1,397,1504,1107
4251,0,0,47,0,-47
4252,1,1,612,1318,706
4253,1,0,1,0,-1
4254,0,0,34,0,-34
4255,1,1,911,1295,384
4256,0,0,32,0,-32
4257,0,0,3,0,-3
4258,1,0,84,0,-84
4259,1,1,283,1798,1515
4260,1,0,74,0,-74
4261,0,0,7,0,-7
4262,1,1,48,1776,1728
4263,1,1,399,1253,854
4264,1,1,174,1735,1561
4265,0,0,35,0,-35
4266,0,0,26,0,-26
4267,1,0,96,0,-96
4268,1,0,107,0,-107
4269,0,0,16,0,-16
4270,1,1,48,1493,1445
4271,0,0,72,0,-72
4272,1,1,208,2172,1964
4273,1,0,1,0,-1
4274,0,0,8,0,-8
4275,0,0,60,0,-60
4276,0,0,14,0,-14
4277,1,1,32,1524,1492
4278,0,0,18,0,-18
4279,0,0,48,0,-48
4280,0,0,33,0,-33
4281,1,0,31,0,-31
4282,1,0,28,0,-28
4283,0,0,24,0,-24
4284,1,1,1185,1523,338
4285,0,0,50,0,-50
4286,1,1,312,1518,1206
4287,1,0,57,0,-57
4288,0,0,17,0,-17
4289,1,0,7,0,-7
4290,1,1,326,1236,910
4291,1,1,715,1266,551
4292,0,0,26,0,-26
4293,0,0,21,0,-21
4294,1,1,31,1297,1266
4295,1,0,13,0,-13
4296,0,0,7,0,-7
4297,1,1,1275,1534,259
4298,0,0,2,0,-2
4299,0,0,23,0,-23
4300,0,0,4,0,-4
4301,1,0,125,0,-125
4302,1,1,617,1358,741
4303,0,0,20,0,-20
4304,1,0,60,0,-60
4305,1,0,11,0,-11
4306,1,0,12,0,-12
4307,0,0,6,0,-6
4308,1,1,416,3110,2694
4309,0,0,35,0,-35
4310,1,0,30,0,-30
4311,1,0,1,0,-1
4312,1,1,543,1671,1128
4313,0,0,106,0,-106
4314,1,1,163,1985,1822
4315,0,0,72,0,-72
4316,1,0,8,0,-8
4317,1,0,158,0,-158
4318,1,1,520,1416,896
4319,1,0,117,0,-117
4320,1,1,247,1821,1574
4321,1,0,30,0,-30
4322,1,1,468,1236,768
4323,1,0,78,0,-78
4324,1,1,1217,1292,75
4325,0,0,26,0,-26
4326,0,0,4,0,-4
4327,1,1,238,1282,1044
4328,1,0,57,0,-57
4329,1,0,86,0,-86
4330,1,0,71,0,-71
4331,1,0,79,0,-79
4332,1,0,75,0,-75
4333,0,0,13,0,-13
4334,1,0,51,0,-51
4335,1,0,18,0,-18
4336,0,0,20,0,-20
4337,1,0,9,0,-9
4338,0,0,54,0,-54
4339,1,0,13,0,-13
4340,1,0,129,0,-129
4341,1,0,35,0,-35
4342,0,0,35,0,-35
4343,0,0,17,0,-17
4344,0,0,49,0,-49
4345,0,0,171,0,-171
4346,1,1,98,1514,1416
4347,1,1,370,1407,1037
4348,0,0,6,0,-6
4349,0,0,64,0,-64
4350,1,1,621,1257,636
4351,1,1,791,1600,809
4352,0,0,224,0,-224
4353,1,1,402,1512,1110
4354,0,0,23,0,-23
4355,1,1,662,1523,861
4356,1,1,56,1717,1661
4357,1,1,106,3210,3104
4358,0,0,14,0,-14
4359,0,0,101,0,-101
4360,1,0,17,0,-17
4361,0,0,9,0,-9
4362,1,0,11,0,-11
4363,1,0,22,0,-22
4364,1,1,114,1364,1250
4365,1,0,4,0,-4
4366,0,0,144,0,-144
4367,1,0,59,0,-59
4368,1,0,190,0,-190
4369,1,0,84,0,-84
4370,1,0,69,0,-69
4371,1,0,35,0,-35
4372,1,0,13,0,-13
4373,0,0,74,0,-74
4374,1,1,228,3018,2790
4375,1,1,227,1932,1705
4376,0,0,30,0,-30
4377,0,0,59,0,-59
4378,1,0,225,0,-225
4379,0,0,2,0,-2
4380,0,0,110,0,-110
4381,1,1,713,1355,642
4382,0,0,86,0,-86
4383,1,1,106,1356,1250
4384,1,1,1247,1358,111
4385,1,1,165,1633,1468
4386,1,1,28,1737,1709
4387,1,0,9,0,-9
4388,0,0,41,0,-41
4389,1,0,81,0,-81
4390,1,1,48,1527,1479
4391,1,1,592,1253,661
4392,1,1,140,1721,1581
4393,0,0,11,0,-11
4394,1,0,5,0,-5
4395,0,0,63,0,-63
4396,0,0,216,0,-216
4397,1,1,182,1277,1095
4398,0,0,67,0,-67
4399,0,0,32,0,-32
4400,1,0,19,0,-19
4401,1,1,561,1770,1209
4402,1,1,312,1236,924
4403,1,1,154,1693,1539
4404,1,0,108,0,-108
4405,1,0,110,0,-110
4406,0,0,61,0,-61
4407,0,0,1,0,-1
4408,1,1,947,1354,407
4409,1,0,30,0,-30
4410,0,0,86,0,-86
4411,0,0,1,0,-1
4412,0,0,67,0,-67
4413,0,0,16,0,-16
4414,0,0,26,0,-26
4415,1,1,303,2874,2571
4416,0,0,106,0,-106
4417,1,1,104,2137,2033
4418,1,0,68,0,-68
4419,0,0,64,0,-64
4420,1,0,45,0,-45
4421,1,0,21,0,-21
4422,1,1,300,2296,1996
4423,1,1,328,1470,1142
4424,1,1,212,1488,1276
4425,0,0,20,0,-20
4426,0,0,31,0,-31
4427,0,0,34,0,-34
4428,0,0,53,0,-53
4429,1,1,74,1266,1192
4430,1,1,420,1256,836
4431,1,1,209,1391,1182
4432,0,0,18,0,-18
4433,1,1,148,1610,1462
4434,0,0,76,0,-76
4435,0,0,83,0,-83
4436,0,0,9,0,-9
4437,0,0,31,0,-31
4438,0,0,11,0,-11
4439,1,1,1420,1755,335
4440,1,1,172,1241,1069
4441,0,0,18,0,-18
4442,0,0,11,0,-11
4443,0,0,20,0,-20
4444,0,0,37,0,-37
4445,0,0,88,0,-88
4446,1,1,1552,1657,105
4447,1,0,6,0,-6
4448,0,0,83,0,-83
4449,1,1,87,4800,4713
4450,1,1,54,1585,1531
4451,1,1,649,1689,1040
4452,1,1,1031,1444,413
4453,1,1,1010,1885,875
4454,0,0,12,0,-12
4455,0,0,6,0,-6
4456,1,0,45,0,-45
4457,0,0,78,0,-78
4458,1,0,7,0,-7
4459,1,0,60,0,-60
4460,1,0,43,0,-43
4461,1,1,514,1311,797
4462,1,1,559,1690,1131
4463,0,0,40,0,-40
4464,1,1,163,1306,1143
4465,1,0,6,0,-6
4466,1,0,4,0,-4
4467,1,1,1532,1399,-133
4468,1,0,71,0,-71
4469,0,0,76,0,-76
4470,1,1,102,1459,1357
4471,0,0,138,0,-138
4472,1,1,333,2824,2491
4473,1,0,8,0,-8
4474,0,0,30,0,-30
4475,0,0,23,0,-23
4476,0,0,79,0,-79
4477,1,1,712,1480,768
4478,0,0,15,0,-15
4479,1,1,297,1359,1062
4480,1,0,46,0,-46
4481,1,0,7,0,-7
4482,1,1,928,1386,458
4483,0,0,44,0,-44
4484,0,0,70,0,-70
4485,1,0,5,0,-5
4486,0,0,2,0,-2
4487,0,0,17,0,-17
4488,1,1,478,1617,1139
4489,0,0,103,0,-103
4490,1,1,592,1264,672
4491,0,0,8,0,-8
4492,0,0,8,0,-8
4493,1,1,133,1299,1166
4494,0,0,46,0,-46
4495,0,0,19,0,-19
4496,1,0,28,0,-28
4497,0,0,32,0,-32
4498,1,1,334,3405,3071
4499,1,0,14,0,-14
4500,1,0,13,0,-13
4501,0,0,15,0,-15
4502,1,1,475,1616,1141
4503,1,0,46,0,-46
4504,1,1,421,1484,1063
4505,0,0,39,0,-39
4506,1,1,543,1453,910
4507,0,0,16,0,-16
4508,0,0,9,0,-9
4509,0,0,30,0,-30
4510,1,1,364,1631,1267
4511,1,0,81,0,-81
4512,0,0,3,0,-3
4513,0,0,12,0,-12
4514,1,0,69,0,-69
4515,1,0,158,0,-158
4516,0,0,21,0,-21
4517,1,0,44,0,-44
4518,1,0,34,0,-34
4519,1,0,8,0,-8
4520,1,1,242,1615,1373
4521,0,0,190,0,-190
4522,0,0,40,0,-40
4523,1,1,287,1317,1030
4524,0,0,166,0,-166
4525,0,0,20,0,-20
4526,0,0,59,0,-59
4527,1,0,15,0,-15
4528,1,1,514,1250,736
4529,1,0,58,0,-58
4530,0,0,2,0,-2
4531,0,0,2,0,-2
4532,1,0,32,0,-32
4533,1,0,29,0,-29
4534,1,0,36,0,-36
4535,1,0,24,0,-24
4536,0,0,25,0,-25
4537,0,0,7,0,-7
4538,1,1,470,1508,1038
4539,1,0,191,0,-191
4540,1,1,554,3339,2785
4541,1,0,83,0,-83
4542,0,0,14,0,-14
4543,1,0,115,0,-115
4544,1,1,513,1881,1368
4545,0,0,33,0,-33
4546,1,1,1263,1370,107
4547,0,0,2,0,-2
4548,1,0,94,0,-94
4549,0,0,241,0,-241
4550,1,0,13,0,-13
4551,0,0,8,0,-8
4552,0,0,13,0,-13
4553,0,0,25,0,-25
4554,0,0,10,0,-10
4555,1,0,0,0,0
4556,1,1,631,1368,737
4557,1,1,512,1384,872
4558,1,0,24,0,-24
4559,1,1,1152,1334,182
4560,1,1,256,1450,1194
4561,1,1,458,1747,1289
4562,0,0,16,0,-16
4563,0,0,16,0,-16
4564,1,0,66,0,-66
4565,1,0,69,0,-69
4566,1,1,360,1402,1042
4567,1,1,41,3210,3169
4568,0,0,204,0,-204
4569,1,0,6,0,-6
4570,0,0,43,0,-43
4571,0,0,8,0,-8
4572,1,1,12,1425,1413
4573,1,1,373,1752,1379
4574,0,0,23,0,-23
4575,1,1,461,2553,2092
4576,1,1,578,6383,5805
4577,0,0,15,0,-15
4578,0,0,13,0,-13
4579,1,1,1391,1361,-30
4580,0,0,2,0,-2
4581,1,1,27,1354,1327
4582,0,0,120,0,-120
4583,1,1,1098,1984,886
4584,1,0,29,0,-29
4585,1,1,212,1292,1080
4586,1,0,36,0,-36
4587,1,1,496,2060,1564
4588,1,0,13,0,-13
4589,0,0,14,0,-14
4590,0,0,83,0,-83
4591,0,0,47,0,-47
4592,1,0,48,0,-48
4593,1,0,100,0,-100
4594,1,0,1,0,-1
4595,0,0,22,0,-22
4596,0,0,4,0,-4
4597,1,1,204,1262,1058
4598,1,1,776,1507,731
4599,0,0,207,0,-207
4600,0,0,21,0,-21
4601,1,1,124,1246,1122
4602,0,0,136,0,-136
4603,0,0,39,0,-39
4604,1,1,797,2098,1301
4605,0,0,2,0,-2
4606,1,0,46,0,-46
4607,1,1,733,1240,507
4608,1,1,61,1624,1563
4609,0,0,17,0,-17
4610,1,1,550,1331,781
4611,1,0,10,0,-10
4612,0,0,13,0,-13
4613,0,0,28,0,-28
4614,1,1,785,1271,486
4615,1,1,1306,2074,768
4616,0,0,6,0,-6
4617,1,0,71,0,-71
4618,0,0,40,0,-40
4619,0,0,5,0,-5
4620,0,0,111,0,-111
4621,1,0,76,0,-76
4622,1,1,292,1844,1552
4623,1,0,7,0,-7
4624,0,0,18,0,-18
4625,0,0,30,0,-30
4626,0,0,23,0,-23
4627,1,0,27,0,-27
4628,1,0,2,0,-2
4629,1,1,518,1592,1074
4630,1,1,56,1446,1390
4631,0,0,0,0,0
4632,1,1,381,1767,1386
4633,0,0,475,0,-475
4634,0,0,150,0,-150
4635,1,1,659,1302,643
4636,0,0,36,0,-36
4637,1,0,91,0,-91
4638,0,0,303,0,-303
4639,1,1,1114,1356,242
4640,1,0,20,0,-20
4641,0,0,3,0,-3
4642,0,0,58,0,-58
4643,0,0,11,0,-11
4644,1,0,50,0,-50
4645,0,0,45,0,-45
4646,1,1,122,1489,1367
4647,1,0,24,0,-24
4648,1,1,211,1688,1477
4649,1,1,158,1394,1236
4650,1,1,274,1268,994
4651,0,0,29,0,-29
4652,0,0,4,0,-4
4653,1,1,37,1871,1834
4654,1,1,489,1727,1238
4655,0,0,35,0,-35
4656,0,0,102,0,-102
4657,1,1,725,1544,819
4658,1,0,42,0,-42
4659,1,0,55,0,-55
4660,1,0,181,0,-181
4661,1,0,35,0,-35
4662,1,1,1354,1564,210
4663,1,1,290,1312,1022
4664,1,1,338,1299,961
4665,1,0,95,0,-95
4666,0,0,46,0,-46
4667,0,0,50,0,-50
4668,0,0,68,0,-68
4669,1,0,42,0,-42
4670,0,0,17,0,-17
4671,0,0,13,0,-13
4672,0,0,34,0,-34
4673,1,1,239,1275,1036
4674,0,0,52,0,-52
4675,0,0,2,0,-2
4676,0,0,43,0,-43
4677,1,1,571,1626,1055
4678,1,0,2,0,-2
4679,0,0,106,0,-106
4680,1,1,81,2604,2523
4681,0,0,7,0,-7
4682,0,0,4,0,-4
4683,1,1,621,1297,676
4684,0,0,108,0,-108
4685,0,0,18,0,-18
4686,1,0,84,0,-84
4687,0,0,45,0,-45
4688,0,0,55,0,-55
4689,0,0,72,0,-72
4690,0,0,19,0,-19
4691,0,0,14,0,-14
4692,1,0,53,0,-53
4693,0,0,50,0,-50
4694,0,0,3,0,-3
4695,1,1,483,1259,776
4696,1,1,108,1289,1181
4697,0,0,63,0,-63
4698,1,1,105,1310,1205
4699,0,0,115,0,-115
4700,0,0,11,0,-11
4701,1,1,68,1463,1395
4702,1,1,526,1752,1226
4703,0,0,26,0,-26
4704,0,0,19,0,-19
4705,1,0,4,0,-4
4706,1,0,39,0,-39
4707,1,0,74,0,-74
4708,1,1,76,1412,1336
4709,1,1,1043,1340,297
4710,1,1,558,1955,1397
4711,1,0,21,0,-21
4712,1,0,31,0,-31
4713,1,1,323,2166,1843
4714,1,0,78,0,-78
4715,0,0,18,0,-18
4716,1,0,22,0,-22
4717,0,0,24,0,-24
4718,0,0,45,0,-45
4719,0,0,35,0,-35
4720,1,1,229,1943,1714
4721,1,0,43,0,-43
4722,1,1,655,1750,1095
4723,1,0,98,0,-98
4724,1,1,229,1399,1170
4725,0,0,20,0,-20
4726,1,0,8,0,-8
4727,1,0,6,0,-6
4728,0,0,99,0,-99
4729,1,0,32,0,-32
4730,1,1,386,1610,1224
4731,1,0,73,0,-73
4732,1,1,165,1324,1159
4733,0,0,27,0,-27
4734,0,0,21,0,-21
4735,1,1,433,1276,843
4736,1,0,58,0,-58
4737,1,1,1726,1279,-447
4738,1,1,454,1747,1293
4739,1,0,65,0,-65
4740,1,1,495,1347,852
4741,1,1,1547,1250,-297
4742,0,0,42,0,-42
4743,1,0,125,0,-125
4744,1,1,514,1280,766
4745,1,1,545,1727,1182
4746,1,1,109,1248,1139
4747,0,0,48,0,-48
4748,1,0,119,0,-119
4749,1,0,29,0,-29
4750,1,0,2,0,-2
4751,1,1,1085,2154,1069
4752,1,1,352,1330,978
4753,0,0,30,0,-30
4754,0,0,38,0,-38
4755,1,1,36,1270,1234
4756,0,0,95,0,-95
4757,0,0,7,0,-7
4758,0,0,25,0,-25
4759,0,0,14,0,-14
4760,0,0,20,0,-20
4761,0,0,64,0,-64
4762,0,0,89,0,-89
4763,1,1,352,1823,1471
4764,1,0,46,0,-46
4765,0,0,30,0,-30
4766,1,1,246,1704,1458
4767,0,0,124,0,-124
4768,1,0,89,0,-89
4769,0,0,1,0,-1
4770,0,0,25,0,-25
4771,1,1,186,1582,1396
4772,1,1,60,3953,3893
4773,1,1,208,1325,1117
4774,1,1,893,2531,1638
4775,1,1,341,1252,911
4776,1,0,20,0,-20
4777,1,1,39,1347,1308
4778,1,1,1359,1296,-63
4779,0,0,13,0,-13
4780,1,0,0,0,0
4781,1,0,17,0,-17
4782,1,0,9,0,-9
4783,1,1,376,1393,1017
4784,1,1,1598,2370,772
4785,1,0,1,0,-1
4786,0,0,33,0,-33
4787,0,0,149,0,-149
4788,0,0,178,0,-178
4789,0,0,40,0,-40
4790,1,1,591,1518,927
4791,0,0,161,0,-161
4792,0,0,0,0,0
4793,1,0,92,0,-92
4794,1,1,415,2542,2127
4795,1,0,19,0,-19
4796,1,1,262,1289,1027
4797,0,0,5,0,-5
4798,0,0,35,0,-35
4799,0,0,165,0,-165
4800,1,0,92,0,-92
4801,1,1,372,1417,1045
4802,1,1,1351,2384,1033
4803,1,1,352,1575,1223
4804,1,1,1429,1400,-29
4805,0,0,13,0,-13
4806,0,0,82,0,-82
4807,1,1,794,1278,484
4808,1,1,307,1696,1389
4809,1,0,112,0,-112
4810,1,1,457,2768,2311
4811,1,1,91,4844,4753
4812,1,1,567,1402,835
4813,1,1,40,1739,1699
4814,1,0,5,0,-5
4815,1,0,6,0,-6
4816,0,0,55,0,-55
4817,0,0,9,0,-9
4818,0,0,27,0,-27
4819,0,0,72,0,-72
4820,0,0,34,0,-34
4821,0,0,14,0,-14
4822,1,1,1063,2343,1280
4823,1,1,236,1421,1185
4824,0,0,3,0,-3
4825,1,0,54,0,-54
4826,1,1,351,1404,1053
4827,1,1,244,2246,2002
4828,1,0,21,0,-21
4829,1,0,44,0,-44
4830,1,0,26,0,-26
4831,1,1,31,1351,1320
4832,1,0,13,0,-13
4833,0,0,0,0,0
4834,1,0,43,0,-43
4835,1,0,3,0,-3
4836,1,1,525,2148,1623
4837,1,1,1505,1325,-180
4838,1,1,1523,1302,-221
4839,1,0,29,0,-29
4840,0,0,34,0,-34
4841,1,0,46,0,-46
4842,0,0,1,0,-1
4843,1,1,726,1440,714
4844,0,0,4,0,-4
4845,1,1,540,1318,778
4846,0,0,0,0,0
4847,1,1,1614,1387,-227
4848,0,0,11,0,-11
4849,1,0,116,0,-116
4850,0,0,46,0,-46
4851,0,0,18,0,-18
4852,1,1,375,1831,1456
4853,1,1,170,4088,3918
4854,1,0,28,0,-28
4855,0,0,51,0,-51
4856,1,0,16,0,-16
4857,1,1,399,1736,1337
4858,1,1,1785,2010,225
4859,1,0,3,0,-3
4860,1,0,21,0,-21
4861,1,0,21,0,-21
4862,0,0,22,0,-22
4863,1,1,1978,1334,-644
4864,1,1,1644,1379,-265
4865,1,0,70,0,-70
4866,1,1,608,1411,803
4867,1,1,690,1236,546
4868,0,0,159,0,-159
4869,0,0,51,0,-51
4870,1,0,42,0,-42
4871,0,0,6,0,-6
4872,0,0,94,0,-94
4873,0,0,27,0,-27
4874,1,1,885,1331,446
4875,0,0,115,0,-115
4876,1,0,35,0,-35
4877,1,1,511,1437,926
4878,0,0,23,0,-23
4879,1,0,2,0,-2
4880,1,0,5,0,-5
4881,1,0,14,0,-14
4882,0,0,1,0,-1
4883,1,1,341,3276,2935
4884,0,0,120,0,-120
4885,1,0,4,0,-4
4886,0,0,18,0,-18
4887,1,1,216,1712,1496
4888,1,1,340,1421,1081
4889,0,0,22,0,-22
4890,0,0,1,0,-1
4891,0,0,11,0,-11
4892,1,0,37,0,-37
4893,1,0,88,0,-88
4894,0,0,82,0,-82
4895,1,0,108,0,-108
4896,0,0,55,0,-55
4897,1,0,138,0,-138
4898,0,0,158,0,-158
4899,1,1,482,1554,1072
4900,1,1,504,1268,764
4901,0,0,24,0,-24
4902,1,0,51,0,-51
4903,1,0,91,0,-91
4904,1,0,30,0,-30
4905,0,0,0,0,0
4906,0,0,9,0,-9
4907,0,0,186,0,-186
4908,1,1,19,1529,1510
4909,1,1,237,1279,1042
4910,0,0,62,0,-62
4911,1,1,467,1284,817
4912,1,1,1090,1501,411
4913,0,0,89,0,-89
4914,0,0,21,0,-21
4915,1,0,25,0,-25
4916,0,0,21,0,-21
4917,1,0,37,0,-37
4918,0,0,25,0,-25
4919,1,1,2175,1274,-901
4920,0,0,2,0,-2
4921,0,0,3,0,-3
4922,1,1,201,1287,1086
4923,0,0,7,0,-7
4924,1,1,809,1606,797
4925,1,1,175,1445,1270
4926,1,1,195,2928,2733
4927,1,1,246,1997,1751
4928,1,0,17,0,-17
4929,1,0,8,0,-8
4930,0,0,104,0,-104
4931,1,0,44,0,-44
4932,0,0,2,0,-2
4933,1,1,244,2249,2005
4934,0,0,76,0,-76
4935,1,1,16,1236,1220
4936,1,0,30,0,-30
4937,1,0,104,0,-104
4938,0,0,0,0,0
4939,1,0,11,0,-11
4940,0,0,32,0,-32
4941,0,0,115,0,-115
4942,1,1,556,1330,774
4943,0,0,42,0,-42
4944,0,0,45,0,-45
4945,0,0,401,0,-401
4946,0,0,1,0,-1
4947,0,0,20,0,-20
4948,1,1,500,1525,1025
4949,0,0,30,0,-30
4950,1,1,308,2486,2178
4951,0,0,62,0,-62
4952,1,1,43,1333,1290
4953,1,0,49,0,-49
4954,0,0,154,0,-154
4955,1,1,552,1418,866
4956,0,0,21,0,-21
4957,1,0,21,0,-21
4958,1,1,131,2838,2707
4959,1,1,60,1763,1703
4960,1,1,768,1293,525
4961,0,0,89,0,-89
4962,1,0,10,0,-10
4963,0,0,10,0,-10
4964,1,0,194,0,-194
4965,1,0,111,0,-111
4966,0,0,20,0,-20
4967,1,1,555,1484,929
4968,0,0,1,0,-1
4969,1,0,22,0,-22
4970,1,1,1087,1253,166
4971,0,0,28,0,-28
4972,0,0,55,0,-55
4973,0,0,11,0,-11
4974,0,0,99,0,-99
4975,1,0,32,0,-32
4976,1,1,214,1344,1130
4977,1,1,247,1261,1014
4978,0,0,34,0,-34
4979,0,0,3,0,-3
4980,0,0,4,0,-4
4981,1,1,195,1911,1716
4982,1,1,356,1286,930
4983,1,0,3,0,-3
4984,1,0,58,0,-58
4985,1,1,84,1334,1250
4986,0,0,167,0,-167
4987,1,0,31,0,-31
4988,0,0,25,0,-25
4989,0,0,16,0,-16
4990,0,0,40,0,-40
4991,0,0,65,0,-65
4992,1,0,12,0,-12
4993,1,1,179,1328,1149
4994,1,1,333,1287,954
4995,0,0,20,0,-20
4996,1,0,107,0,-107
4997,1,1,142,1454,1312
4998,1,0,29,0,-29
4999,1,1,23,1385,1362
5000,1,0,103,0,-103
5001,1,1,558,1240,682
5002,0,0,22,0,-22
5003,0,0,63,0,-63
5004,0,0,147,0,-147
5005,0,0,123,0,-123
5006,0,0,1,0,-1
5007,0,0,33,0,-33
5008,1,1,396,1243,847
5009,1,0,3,0,-3
5010,1,0,48,0,-48
5011,0,0,50,0,-50
5012,0,0,6,0,-6
5013,1,1,100,1571,1471
5014,0,0,11,0,-11
5015,1,0,103,0,-103
5016,1,0,7,0,-7
5017,1,0,24,0,-24
5018,1,1,385,1549,1164
5019,1,0,14,0,-14
5020,1,0,97,0,-97
5021,1,0,1,0,-1
5022,1,1,2313,1438,-875
5023,0,0,152,0,-152
5024,1,0,67,0,-67
5025,1,0,12,0,-12
5026,1,1,512,1918,1406
5027,0,0,49,0,-49
5028,1,1,544,1705,1161
5029,0,0,12,0,-12
5030,1,0,63,0,-63
5031,0,0,4,0,-4
5032,0,0,1,0,-1
5033,1,1,240,2222,1982
5034,0,0,112,0,-112
5035,1,1,283,1316,1033
5036,1,1,195,1310,1115
5037,1,1,713,1277,564
5038,1,0,99,0,-99
5039,0,0,79,0,-79
5040,1,0,229,0,-229
5041,1,1,521,1428,907
5042,1,1,152,1425,1273
5043,1,0,26,0,-26
5044,0,0,5,0,-5
5045,0,0,36,0,-36
5046,1,0,10,0,-10
5047,1,1,637,1344,707
5048,1,0,71,0,-71
5049,0,0,13,0,-13
5050,0,0,65,0,-65
5051,0,0,51,0,-51
5052,0,0,84,0,-84
5053,1,1,630,1365,735
5054,0,0,25,0,-25
5055,1,0,42,0,-42
5056,1,0,1,0,-1
5057,0,0,18,0,-18
5058,1,0,31,0,-31
5059,1,0,211,0,-211
5060,1,0,20,0,-20
5061,1,0,30,0,-30
5062,1,0,11,0,-11
5063,0,0,1,0,-1
5064,0,0,93,0,-93
5065,1,1,308,1264,956
5066,0,0,31,0,-31
5067,1,0,31,0,-31
5068,0,0,52,0,-52
5069,1,1,40,1348,1308
5070,1,0,83,0,-83
5071,1,0,12,0,-12
5072,1,0,11,0,-11
5073,1,0,73,0,-73
5074,0,0,57,0,-57
5075,0,0,125,0,-125
5076,0,0,16,0,-16
5077,0,0,35,0,-35
5078,1,0,12,0,-12
5079,0,0,14,0,-14
5080,0,0,40,0,-40
5081,1,1,766,1338,572
5082,1,1,617,1571,954
5083,1,1,213,1824,1611
5084,1,1,374,1420,1046
5085,0,0,82,0,-82
5086,0,0,26,0,-26
5087,0,0,3,0,-3
5088,0,0,34,0,-34
5089,1,0,110,0,-110
5090,1,0,43,0,-43
5091,1,0,15,0,-15
5092,0,0,62,0,-62
5093,1,0,34,0,-34
5094,1,1,401,1901,1500
5095,0,0,23,0,-23
5096,0,0,32,0,-32
5097,0,0,87,0,-87
5098,1,0,18,0,-18
5099,0,0,74,0,-74
5100,1,0,30,0,-30
5101,0,0,19,0,-19
5102,0,0,164,0,-164
5103,1,1,1072,1336,264
5104,0,0,26,0,-26
5105,1,1,125,2639,2514
5106,1,1,795,1355,560
5107,1,0,56,0,-56
5108,1,0,74,0,-74
5109,0,0,353,0,-353
5110,0,0,38,0,-38
5111,1,0,37,0,-37
5112,0,0,73,0,-73
5113,1,1,249,1603,1354
5114,1,0,38,0,-38
5115,0,0,167,0,-167
5116,1,1,480,1306,826
5117,0,0,49,0,-49
5118,1,0,79,0,-79
5119,1,0,5,0,-5
5120,0,0,230,0,-230
5121,1,1,953,1456,503
5122,1,1,869,2027,1158
5123,1,1,661,1276,615
5124,1,1,241,2125,1884
5125,1,1,757,1279,522
5126,1,0,7,0,-7
5127,1,1,501,2245,1744
5128,0,0,66,0,-66
5129,1,0,33,0,-33
5130,0,0,42,0,-42
5131,1,0,6,0,-6
5132,0,0,1,0,-1
5133,1,0,49,0,-49
5134,1,0,22,0,-22
5135,0,0,24,0,-24
5136,1,1,355,1272,917
5137,1,0,64,0,-64
5138,1,0,22,0,-22
5139,0,0,38,0,-38
5140,0,0,83,0,-83
5141,1,0,12,0,-12
5142,1,1,126,1244,1118
5143,0,0,11,0,-11
5144,1,0,43,0,-43
5145,1,1,362,1238,876
5146,0,0,61,0,-61
5147,1,1,762,1252,490
5148,0,0,135,0,-135
5149,1,1,1186,1263,77
5150,1,1,220,2698,2478
5151,1,0,15,0,-15
5152,0,0,37,0,-37
5153,0,0,84,0,-84
5154,1,1,96,1309,1213
5155,1,1,1450,1495,45
5156,1,1,901,2248,1347
5157,1,1,1015,1324,309
5158,0,0,43,0,-43
5159,1,0,30,0,-30
5160,0,0,16,0,-16
5161,1,0,22,0,-22
5162,0,0,186,0,-186
5163,1,1,2294,1663,-631
5164,0,0,1,0,-1
5165,1,0,86,0,-86
5166,1,0,47,0,-47
5167,0,0,225,0,-225
5168,1,1,461,1951,1490
5169,0,0,70,0,-70
5170,1,0,43,0,-43
5171,1,0,23,0,-23
5172,1,0,78,0,-78
5173,1,1,394,3632,3238
5174,0,0,35,0,-35
5175,1,0,9,0,-9
5176,1,0,13,0,-13
5177,1,0,27,0,-27
5178,1,1,148,1402,1254
5179,1,0,27,0,-27
5180,0,0,93,0,-93
5181,1,0,38,0,-38
5182,1,1,157,1440,1283
5183,1,1,160,1278,1118
5184,1,1,18,2800,2782
5185,1,0,8,0,-8
5186,0,0,18,0,-18
5187,1,0,4,0,-4
5188,1,1,1923,1271,-652
5189,1,0,34,0,-34
5190,1,0,17,0,-17
5191,1,0,4,0,-4
5192,1,0,71,0,-71
5193,1,0,207,0,-207
5194,0,0,18,0,-18
5195,0,0,6,0,-6
5196,0,0,19,0,-19
5197,1,1,654,1788,1134
5198,0,0,150,0,-150
5199,0,0,197,0,-197
5200,0,0,15,0,-15
5201,0,0,15,0,-15
5202,0,0,4,0,-4
5203,1,0,25,0,-25
5204,1,0,21,0,-21
5205,0,0,81,0,-81
5206,1,0,56,0,-56
5207,0,0,89,0,-89
5208,0,0,8,0,-8
5209,1,0,20,0,-20
5210,1,0,27,0,-27
5211,1,1,199,1317,1118
5212,1,1,1018,1576,558
5213,1,0,32,0,-32
5214,1,0,46,0,-46
5215,0,0,125,0,-125
5216,1,1,90,1250,1160
5217,1,1,900,2078,1178
5218,0,0,13,0,-13
5219,0,0,26,0,-26
5220,1,1,158,1446,1288
5221,1,0,115,0,-115
5222,0,0,13,0,-13
5223,1,1,519,1285,766
5224,0,0,72,0,-72
5225,1,1,393,1368,975
5226,1,0,109,0,-109
5227,0,0,105,0,-105
5228,0,0,8,0,-8
5229,0,0,17,0,-17
5230,1,1,399,2240,1841
5231,1,0,5,0,-5
5232,1,1,483,1323,840
5233,1,1,1024,1338,314
5234,1,1,586,1670,1084
5235,1,0,99,0,-99
5236,1,0,2,0,-2
5237,1,0,7,0,-7
5238,1,1,242,2672,2430
5239,0,0,116,0,-116
5240,1,1,639,1926,1287
5241,0,0,198,0,-198
5242,1,0,1,0,-1
5243,1,1,49,1314,1265
5244,1,1,418,1556,1138
5245,1,0,1,0,-1
5246,1,0,123,0,-123
5247,1,0,3,0,-3
5248,0,0,6,0,-6
5249,1,0,164,0,-164
5250,1,1,453,1677,1224
5251,1,0,45,0,-45
5252,1,1,1057,1662,605
5253,0,0,34,0,-34
5254,1,1,790,1810,1020
5255,0,0,41,0,-41
5256,0,0,65,0,-65
5257,1,1,261,1337,1076
5258,1,1,1376,1312,-64
5259,1,0,6,0,-6
5260,1,1,296,2031,1735
5261,1,0,9,0,-9
5262,1,1,2377,1349,-1028
5263,0,0,53,0,-53
5264,0,0,36,0,-36
5265,1,0,97,0,-97
5266,0,0,63,0,-63
5267,1,1,79,1504,1425
5268,0,0,35,0,-35
5269,1,1,130,1282,1152
5270,1,1,60,1356,1296
5271,1,0,14,0,-14
5272,1,1,1473,1285,-188
5273,0,0,3,0,-3
5274,1,0,84,0,-84
5275,0,0,6,0,-6
5276,1,0,46,0,-46
5277,0,0,48,0,-48
5278,1,1,74,1558,1484
5279,1,0,53,0,-53
5280,0,0,12,0,-12
5281,1,0,58,0,-58
5282,0,0,11,0,-11
5283,0,0,1,0,-1
5284,0,0,121,0,-121
5285,0,0,2,0,-2
5286,0,0,97,0,-97
5287,1,1,243,1640,1397
5288,1,0,53,0,-53
5289,1,0,4,0,-4
5290,1,1,1756,1395,-361
5291,1,1,1325,1747,422
5292,1,0,79,0,-79
5293,0,0,21,0,-21
5294,1,0,16,0,-16
5295,0,0,57,0,-57
5296,0,0,59,0,-59
5297,0,0,5,0,-5
5298,0,0,9,0,-9
5299,1,1,717,1713,996
5300,0,0,35,0,-35
5301,1,0,5,0,-5
5302,1,1,125,1314,1189
5303,1,0,25,0,-25
5304,1,1,1009,1740,731
5305,0,0,31,0,-31
5306,1,0,34,0,-34
5307,1,0,10,0,-10
5308,1,1,811,2539,1728
5309,1,0,42,0,-42
5310,1,0,57,0,-57
5311,1,1,610,1992,1382
5312,1,1,116,1363,1247
5313,0,0,40,0,-40
5314,1,1,388,1245,857
5315,0,0,29,0,-29
5316,1,0,109,0,-109
5317,1,1,766,1280,514
5318,1,0,7,0,-7
5319,1,0,77,0,-77
5320,0,0,44,0,-44
5321,1,0,4,0,-4
5322,1,0,92,0,-92
5323,1,1,272,1360,1088
5324,1,1,590,1287,697
5325,1,1,131,1411,1280
5326,1,1,2116,1955,-161
5327,1,0,160,0,-160
5328,0,0,63,0,-63
5329,1,1,86,2488,2402
5330,1,0,24,0,-24
5331,1,0,37,0,-37
5332,1,1,58,1287,1229
5333,0,0,40,0,-40
5334,1,1,135,1275,1140
5335,1,1,588,1295,707
5336,0,0,134,0,-134
5337,0,0,75,0,-75
5338,1,1,655,2323,1668
5339,1,0,12,0,-12
5340,1,0,51,0,-51
5341,0,0,39,0,-39
5342,0,0,1,0,-1
5343,0,0,161,0,-161
5344,1,1,348,1310,962
5345,1,0,94,0,-94
5346,1,1,659,1519,860
5347,1,0,23,0,-23
5348,1,0,53,0,-53
5349,1,1,210,2200,1990
5350,1,1,295,2665,2370
5351,0,0,91,0,-91
5352,0,0,50,0,-50
5353,1,0,13,0,-13
5354,1,1,535,1815,1280
5355,0,0,89,0,-89
5356,0,0,35,0,-35
5357,1,1,179,1314,1135
5358,1,1,196,1542,1346
5359,0,0,44,0,-44
5360,1,0,8,0,-8
5361,1,0,4,0,-4
5362,1,0,12,0,-12
5363,1,0,10,0,-10
5364,0,0,7,0,-7
5365,1,0,6,0,-6
5366,0,0,35,0,-35
5367,1,1,1419,1701,282
5368,1,0,25,0,-25
5369,1,0,9,0,-9
5370,1,1,192,1655,1463
5371,0,0,71,0,-71
5372,0,0,64,0,-64
5373,0,0,17,0,-17
5374,1,1,152,1264,1112
5375,1,0,131,0,-131
5376,1,1,201,3800,3599
5377,1,0,125,0,-125
5378,1,1,376,1313,937
5379,1,0,142,0,-142
5380,0,0,12,0,-12
5381,0,0,35,0,-35
5382,1,1,2042,1700,-342
5383,1,0,72,0,-72
5384,0,0,54,0,-54
5385,1,0,20,0,-20
5386,0,0,12,0,-12
5387,0,0,59,0,-59
5388,1,1,164,1608,1444
5389,0,0,16,0,-16
5390,0,0,153,0,-153
5391,1,0,26,0,-26
5392,1,0,26,0,-26
5393,1,1,589,1316,727
5394,1,1,787,1507,720
5395,0,0,1,0,-1
5396,1,0,170,0,-170
5397,0,0,36,0,-36
5398,1,1,123,2210,2087
5399,0,0,2,0,-2
5400,1,1,66,1762,1696
5401,0,0,8,0,-8
5402,1,1,176,1262,1086
5403,0,0,1,0,-1
5404,1,0,44,0,-44
5405,0,0,4,0,-4
5406,1,1,1206,1390,184
5407,1,1,258,2047,1789
5408,1,0,16,0,-16
5409,1,0,5,0,-5
5410,0,0,48,0,-48
5411,0,0,43,0,-43
5412,0,0,38,0,-38
5413,0,0,105,0,-105
5414,1,1,311,1437,1126
5415,1,1,1153,1881,728
5416,1,1,771,1578,807
5417,1,0,36,0,-36
5418,0,0,123,0,-123
5419,1,0,116,0,-116
5420,1,0,12,0,-12
5421,1,1,3246,1237,-2009
5422,1,0,22,0,-22
5423,0,0,20,0,-20
5424,1,0,101,0,-101
5425,0,0,68,0,-68
5426,1,0,9,0,-9
5427,0,0,21,0,-21
5428,0,0,26,0,-26
5429,1,0,22,0,-22
5430,0,0,58,0,-58
5431,1,0,23,0,-23
5432,1,0,23,0,-23
5433,0,0,40,0,-40
5434,0,0,56,0,-56
5435,1,0,135,0,-135
5436,1,0,7,0,-7
5437,1,1,593,1557,964
5438,1,0,205,0,-205
5439,0,0,3,0,-3
5440,1,1,364,1273,909
5441,0,0,3,0,-3
5442,1,0,36,0,-36
5443,1,1,639,1524,885
5444,1,0,83,0,-83
5445,0,0,34,0,-34
5446,0,0,128,0,-128
5447,1,1,113,1302,1189
5448,0,0,161,0,-161
5449,0,0,78,0,-78
5450,1,0,56,0,-56
5451,0,0,23,0,-23
5452,0,0,92,0,-92
5453,0,0,106,0,-106
5454,1,1,1383,1741,358
5455,1,0,6,0,-6
5456,0,0,10,0,-10
5457,0,0,25,0,-25
5458,0,0,12,0,-12
5459,1,0,214,0,-214
5460,1,1,1098,1629,531
5461,0,0,151,0,-151
5462,0,0,3,0,-3
5463,1,0,18,0,-18
5464,0,0,7,0,-7
5465,1,1,900,1338,438
5466,1,0,88,0,-88
5467,1,1,827,1424,597
5468,1,1,232,1428,1196
5469,0,0,57,0,-57
5470,1,1,852,3190,2338
5471,1,0,41,0,-41
5472,1,0,176,0,-176
5473,0,0,53,0,-53
5474,1,0,118,0,-118
5475,1,0,10,0,-10
5476,1,1,1364,2181,817
5477,1,1,189,1415,1226
5478,0,0,13,0,-13
5479,1,1,374,1255,881
5480,1,1,824,1568,744
5481,0,0,4,0,-4
5482,1,1,70,1463,1393
5483,1,1,993,1254,261
5484,1,0,21,0,-21
5485,1,1,285,1261,976
5486,0,0,68,0,-68
5487,0,0,12,0,-12
5488,0,0,112,0,-112
5489,1,1,274,1414,1140
5490,0,0,51,0,-51
5491,0,0,63,0,-63
5492,1,0,20,0,-20
5493,0,0,80,0,-80
5494,1,0,121,0,-121
5495,1,1,211,1682,1471
5496,1,0,2,0,-2
5497,1,1,1132,1245,113
5498,1,0,4,0,-4
5499,0,0,8,0,-8
5500,1,0,62,0,-62
5501,0,0,32,0,-32
5502,0,0,65,0,-65
5503,1,1,44,2394,2350
5504,1,1,342,1268,926
5505,0,0,26,0,-26
5506,1,1,1454,2566,1112
5507,1,0,4,0,-4
5508,0,0,5,0,-5
5509,0,0,54,0,-54
5510,1,1,658,1296,638
5511,1,1,510,1309,799
5512,1,1,385,1338,953
5513,0,0,22,0,-22
5514,1,1,594,1478,884
5515,0,0,6,0,-6
5516,0,0,44,0,-44
5517,1,1,302,1317,1015
5518,1,0,25,0,-25
5519,1,1,1920,3595,1675
5520,0,0,71,0,-71
5521,0,0,20,0,-20
5522,1,0,15,0,-15
5523,1,1,685,1342,657
5524,1,0,213,0,-213
5525,0,0,14,0,-14
5526,1,0,47,0,-47
5527,1,0,58,0,-58
5528,0,0,71,0,-71
5529,0,0,54,0,-54
5530,0,0,11,0,-11
5531,1,1,961,1258,297
5532,0,0,135,0,-135
5533,0,0,5,0,-5
5534,0,0,0,0,0
5535,0,0,2,0,-2
5536,0,0,101,0,-101
5537,1,0,137,0,-137
5538,0,0,18,0,-18
5539,0,0,16,0,-16
5540,0,0,1,0,-1
5541,1,0,136,0,-136
5542,0,0,41,0,-41
5543,1,0,39,0,-39
5544,1,0,49,0,-49
5545,1,0,47,0,-47
5546,0,0,12,0,-12
5547,1,1,395,2041,1646
5548,0,0,15,0,-15
5549,1,1,587,1260,673
5550,1,1,213,1458,1245
5551,0,0,2,0,-2
5552,1,0,0,0,0
5553,0,0,21,0,-21
5554,1,0,96,0,-96
5555,1,0,3,0,-3
5556,0,0,1,0,-1
5557,0,0,10,0,-10
5558,0,0,1,0,-1
5559,0,0,44,0,-44
5560,1,0,43,0,-43
5561,0,0,19,0,-19
5562,1,1,1194,2017,823
5563,1,0,0,0,0
5564,0,0,2,0,-2
5565,1,0,71,0,-71
5566,1,1,160,1403,1243
5567,0,0,60,0,-60
5568,1,1,586,1323,737
5569,1,1,502,2018,1516
5570,1,1,436,1497,1061
5571,0,0,81,0,-81
5572,0,0,4,0,-4
5573,1,0,3,0,-3
5574,1,0,46,0,-46
5575,0,0,88,0,-88
5576,0,0,9,0,-9
5577,0,0,60,0,-60
5578,1,1,924,1452,528
5579,0,0,73,0,-73
5580,0,0,127,0,-127
5581,0,0,12,0,-12
5582,1,0,47,0,-47
5583,1,1,609,1261,652
5584,1,1,50,1847,1797
5585,1,0,39,0,-39
5586,1,0,0,0,0
5587,1,0,0,0,0
5588,1,1,388,1313,925
5589,0,0,116,0,-116
5590,1,1,800,1382,582
5591,0,0,41,0,-41
5592,0,0,94,0,-94
5593,0,0,28,0,-28
5594,1,0,41,0,-41
5595,0,0,1,0,-1
5596,0,0,31,0,-31
5597,1,0,12,0,-12
5598,1,1,384,1252,868
5599,0,0,3,0,-3
5600,1,0,25,0,-25
5601,1,0,39,0,-39
5602,0,0,28,0,-28
5603,1,1,173,1714,1541
5604,1,1,254,1401,1147
5605,1,0,17,0,-17
5606,0,0,111,0,-111
5607,0,0,10,0,-10
5608,1,1,98,1294,1196
5609,0,0,50,0,-50
5610,0,0,2,0,-2
5611,0,0,60,0,-60
5612,0,0,19,0,-19
5613,0,0,97,0,-97
5614,1,0,1,0,-1
5615,0,0,161,0,-161
5616,1,1,396,1291,895
5617,1,1,181,1657,1476
5618,1,0,5,0,-5
5619,1,0,6,0,-6
5620,1,1,240,1380,1140
5621,1,0,20,0,-20
5622,1,0,183,0,-183
5623,1,0,6,0,-6
5624,0,0,27,0,-27
5625,1,0,0,0,0
5626,0,0,38,0,-38
5627,1,1,1666,1460,-206
5628,1,0,48,0,-48
5629,1,1,528,1236,708
5630,0,0,112,0,-112
5631,0,0,3,0,-3
5632,1,0,13,0,-13
5633,0,0,16,0,-16
5634,0,0,30,0,-30
5635,1,0,13,0,-13
5636,1,1,559,1382,823
5637,1,0,12,0,-12
5638,1,1,501,1333,832
5639,0,0,68,0,-68
5640,1,0,15,0,-15
5641,1,1,101,3663,3562
5642,0,0,5,0,-5
5643,1,0,2,0,-2
5644,1,0,17,0,-17
5645,0,0,6,0,-6
5646,0,0,4,0,-4
5647,1,1,466,1566,1100
5648,1,1,85,1448,1363
5649,1,1,392,1246,854
5650,1,1,1092,1338,246
5651,1,1,1406,1254,-152
5652,0,0,145,0,-145
5653,0,0,45,0,-45
5654,1,1,954,1285,331
5655,0,0,90,0,-90
5656,0,0,18,0,-18
5657,1,0,331,0,-331
5658,0,0,7,0,-7
5659,1,0,29,0,-29
5660,1,0,8,0,-8
5661,1,0,22,0,-22
5662,1,1,1025,1722,697
5663,1,0,59,0,-59
5664,1,1,659,1334,675
5665,0,0,44,0,-44
5666,0,0,149,0,-149
5667,0,0,60,0,-60
5668,1,0,9,0,-9
5669,0,0,59,0,-59
5670,0,0,75,0,-75
5671,0,0,8,0,-8
5672,0,0,4,0,-4
5673,0,0,150,0,-150
5674,1,1,213,1296,1083
5675,0,0,189,0,-189
5676,1,1,897,1719,822
5677,0,0,34,0,-34
5678,1,0,13,0,-13
5679,1,1,216,1419,1203
5680,0,0,88,0,-88
5681,0,0,97,0,-97
5682,0,0,66,0,-66
5683,0,0,4,0,-4
5684,0,0,0,0,0
5685,1,1,251,1289,1038
5686,1,1,1732,1568,-164
5687,1,0,15,0,-15
5688,0,0,59,0,-59
5689,1,1,625,1765,1140
5690,1,1,248,1270,1022
5691,0,0,0,0,0
5692,0,0,50,0,-50
5693,1,0,14,0,-14
5694,0,0,94,0,-94
5695,0,0,72,0,-72
5696,0,0,118,0,-118
5697,1,0,87,0,-87
5698,1,1,930,1544,614
5699,0,0,20,0,-20
5700,0,0,12,0,-12
5701,0,0,127,0,-127
5702,0,0,96,0,-96
5703,0,0,6,0,-6
5704,1,1,91,1388,1297
5705,0,0,60,0,-60
5706,1,1,330,1564,1234
5707,0,0,131,0,-131
5708,1,0,52,0,-52
5709,1,1,1114,2576,1462
5710,1,0,6,0,-6
5711,0,0,119,0,-119
5712,0,0,2,0,-2
5713,0,0,100,0,-100
5714,1,0,54,0,-54
5715,1,0,2,0,-2
5716,0,0,14,0,-14
5717,0,0,5,0,-5
5718,0,0,2,0,-2
5719,1,1,458,1266,808
5720,1,0,39,0,-39
5721,1,1,340,1249,909
5722,0,0,16,0,-16
5723,1,0,1,0,-1
5724,0,0,9,0,-9
5725,0,0,64,0,-64
5726,1,0,177,0,-177
5727,1,1,246,1601,1355
5728,1,1,333,1286,953
5729,1,0,58,0,-58
5730,1,1,235,1529,1294
5731,1,1,401,2790,2389
5732,1,1,200,1426,1226
5733,1,1,598,1622,1024
5734,0,0,37,0,-37
5735,1,0,3,0,-3
5736,1,0,14,0,-14
5737,0,0,59,0,-59
5738,1,0,10,0,-10
5739,1,1,209,3223,3014
5740,0,0,6,0,-6
5741,0,0,72,0,-72
5742,1,0,17,0,-17
5743,0,0,14,0,-14
5744,1,0,134,0,-134
5745,0,0,47,0,-47
5746,1,0,99,0,-99
5747,1,1,278,1828,1550
5748,1,0,26,0,-26
5749,1,0,68,0,-68
5750,1,1,1126,1445,319
5751,1,1,780,1565,785
5752,1,1,146,2470,2324
5753,0,0,99,0,-99
5754,1,0,37,0,-37
5755,0,0,34,0,-34
5756,1,1,462,1818,1356
5757,1,1,390,2955,2565
5758,1,1,441,1248,807
5759,0,0,63,0,-63
5760,1,1,31,1356,1325
5761,1,1,404,1252,848
5762,0,0,81,0,-81
5763,1,0,0,0,0
5764,1,1,22,1436,1414
5765,1,1,395,1739,1344
5766,0,0,19,0,-19
5767,1,0,12,0,-12
5768,1,1,1951,2002,51
5769,1,1,34,1521,1487
5770,1,1,293,1386,1093
5771,1,1,1502,1316,-186
5772,1,0,51,0,-51
5773,1,0,66,0,-66
5774,1,0,3,0,-3
5775,1,0,110,0,-110
5776,1,1,250,2066,1816
5777,1,1,1281,1256,-25
5778,1,1,126,2189,2063
5779,0,0,93,0,-93
5780,1,0,81,0,-81
5781,1,0,19,0,-19
5782,0,0,35,0,-35
5783,1,0,81,0,-81
5784,1,1,406,1484,1078
5785,1,0,19,0,-19
5786,1,0,62,0,-62
5787,0,0,52,0,-52
5788,1,0,5,0,-5
5789,0,0,15,0,-15
5790,1,1,715,2794,2079
5791,1,0,22,0,-22
5792,0,0,27,0,-27
5793,0,0,45,0,-45
5794,0,0,64,0,-64
5795,1,1,382,1438,1056
5796,1,1,611,2284,1673
5797,1,0,12,0,-12
5798,0,0,25,0,-25
5799,1,0,73,0,-73
5800,1,0,19,0,-19
5801,1,1,252,1498,1246
5802,0,0,146,0,-146
5803,1,1,561,1359,798
5804,1,0,85,0,-85
5805,0,0,60,0,-60
5806,0,0,71,0,-71
5807,1,1,217,1284,1067
5808,1,1,1112,2463,1351
5809,0,0,71,0,-71
5810,1,0,112,0,-112
5811,1,0,2,0,-2
5812,1,1,404,3371,2967
5813,1,1,768,1312,544
5814,1,0,14,0,-14
5815,1,1,198,2200,2002
5816,0,0,4,0,-4
5817,1,1,431,1365,934
5818,1,0,42,0,-42
5819,1,0,19,0,-19
5820,1,0,116,0,-116
5821,1,1,911,1430,519
5822,1,0,87,0,-87
5823,1,0,53,0,-53
5824,0,0,80,0,-80
5825,0,0,16,0,-16
5826,0,0,20,0,-20
5827,1,1,1361,1474,113
5828,1,1,634,1620,986
5829,0,0,52,0,-52
5830,1,1,691,1476,785
5831,1,0,17,0,-17
5832,0,0,63,0,-63
5833,0,0,64,0,-64
5834,0,0,24,0,-24
5835,1,0,83,0,-83
5836,0,0,40,0,-40
5837,1,0,66,0,-66
5838,1,1,368,1990,1622
5839,1,0,26,0,-26
5840,0,0,29,0,-29
5841,0,0,57,0,-57
5842,1,0,81,0,-81
5843,1,1,809,1254,445
5844,1,1,1221,1412,191
5845,0,0,34,0,-34
5846,1,0,55,0,-55
5847,0,0,2,0,-2
5848,0,0,33,0,-33
5849,0,0,5,0,-5
5850,0,0,53,0,-53
5851,0,0,0,0,0
5852,1,0,43,0,-43
5853,1,0,4,0,-4
5854,1,1,432,1977,1545
5855,0,0,24,0,-24
5856,1,0,46,0,-46
5857,0,0,4,0,-4
5858,0,0,180,0,-180
5859,1,0,127,0,-127
5860,0,0,18,0,-18
5861,1,1,134,1429,1295
5862,1,0,218,0,-218
5863,0,0,132,0,-132
5864,1,1,217,1305,1088
5865,1,0,5,0,-5
5866,1,0,45,0,-45
5867,1,0,44,0,-44
5868,0,0,82,0,-82
5869,0,0,29,0,-29
5870,1,0,33,0,-33
5871,0,0,3,0,-3
5872,1,1,771,1348,577
5873,0,0,60,0,-60
5874,0,0,50,0,-50
5875,1,1,229,1853,1624
5876,0,0,61,0,-61
5877,1,0,28,0,-28
5878,1,0,0,0,0
5879,0,0,53,0,-53
5880,1,1,542,3193,2651
5881,0,0,2,0,-2
5882,0,0,93,0,-93
5883,0,0,65,0,-65
5884,1,1,418,1601,1183
5885,1,1,72,1544,1472
5886,0,0,47,0,-47
5887,0,0,175,0,-175
5888,0,0,32,0,-32
5889,0,0,10,0,-10
5890,0,0,29,0,-29
5891,1,1,189,5970,5781
5892,1,0,5,0,-5
5893,1,0,50,0,-50
5894,0,0,23,0,-23
5895,1,0,16,0,-16
5896,0,0,5,0,-5
5897,1,1,258,1363,1105
5898,0,0,27,0,-27
5899,1,1,225,1423,1198
5900,1,0,20,0,-20
5901,1,0,78,0,-78
5902,1,1,938,1261,323
5903,0,0,65,0,-65
5904,0,0,34,0,-34
5905,1,0,148,0,-148
5906,0,0,117,0,-117
5907,1,1,295,1317,1022
5908,1,0,0,0,0
5909,0,0,142,0,-142
5910,0,0,0,0,0
5911,1,1,462,1322,860
5912,1,0,49,0,-49
5913,1,1,199,1306,1107
5914,1,1,243,1532,1289
5915,1,1,57,1411,1354
5916,1,1,306,2681,2375
5917,1,1,307,1288,981
5918,0,0,2,0,-2
5919,1,0,14,0,-14
5920,1,1,202,1277,1075
5921,0,0,13,0,-13
5922,0,0,10,0,-10
5923,0,0,104,0,-104
5924,1,0,6,0,-6
5925,1,0,9,0,-9
5926,0,0,10,0,-10
5927,0,0,11,0,-11
5928,0,0,8,0,-8
5929,0,0,48,0,-48
5930,1,1,925,1367,442
5931,1,1,129,1792,1663
5932,0,0,67,0,-67
5933,0,0,96,0,-96
5934,0,0,33,0,-33
5935,0,0,75,0,-75
5936,1,1,52,2893,2841
5937,1,0,84,0,-84
5938,0,0,30,0,-30
5939,0,0,73,0,-73
5940,0,0,63,0,-63
5941,1,0,273,0,-273
5942,1,0,83,0,-83
5943,1,0,21,0,-21
5944,0,0,4,0,-4
5945,0,0,53,0,-53
5946,1,0,22,0,-22
5947,1,1,317,1433,1116
5948,1,0,40,0,-40
5949,1,1,162,1681,1519
5950,0,0,35,0,-35
5951,0,0,92,0,-92
5952,1,1,268,1330,1062
5953,0,0,108,0,-108
5954,0,0,140,0,-140
5955,0,0,2,0,-2
5956,0,0,34,0,-34
5957,0,0,22,0,-22
5958,1,0,1,0,-1
5959,0,0,23,0,-23
5960,0,0,13,0,-13
5961,0,0,4,0,-4
5962,1,0,1,0,-1
5963,1,0,20,0,-20
5964,1,1,267,1488,1221
5965,1,1,1686,1554,-132
5966,1,0,119,0,-119
5967,1,0,45,0,-45
5968,1,1,268,2112,1844
5969,1,1,794,1538,744
5970,1,0,0,0,0
5971,0,0,63,0,-63
5972,1,0,21,0,-21
5973,1,0,29,0,-29
5974,1,1,806,1479,673
5975,1,0,2,0,-2
5976,1,1,503,1291,788
5977,1,0,3,0,-3
5978,0,0,29,0,-29
5979,0,0,43,0,-43
5980,0,0,2,0,-2
5981,1,1,83,1995,1912
5982,0,0,65,0,-65
5983,1,1,1588,1585,-3
5984,0,0,27,0,-27
5985,1,0,8,0,-8
5986,1,1,473,1388,915
5987,0,0,231,0,-231
5988,0,0,16,0,-16
5989,1,1,260,1828,1568
5990,1,1,1463,1466,3
5991,1,0,5,0,-5
5992,1,1,198,1715,1517
5993,0,0,30,0,-30
5994,1,0,88,0,-88
5995,0,0,3,0,-3
5996,0,0,30,0,-30
5997,0,0,41,0,-41
5998,1,0,45,0,-45
5999,0,0,108,0,-108
6000,1,0,52,0,-52
6001,1,0,20,0,-20
6002,1,0,2,0,-2
6003,1,1,298,1631,1333
6004,0,0,5,0,-5
6005,0,0,9,0,-9
6006,1,0,6,0,-6
6007,0,0,20,0,-20
6008,0,0,17,0,-17
6009,0,0,101,0,-101
6010,1,0,66,0,-66
6011,0,0,25,0,-25
6012,1,0,9,0,-9
6013,1,0,34,0,-34
6014,1,0,125,0,-125
6015,0,0,43,0,-43
6016,1,0,40,0,-40
6017,1,1,1028,1518,490
6018,0,0,16,0,-16
6019,1,0,10,0,-10
6020,0,0,25,0,-25
6021,1,0,163,0,-163
6022,0,0,6,0,-6
6023,1,1,114,1658,1544
6024,0,0,14,0,-14
6025,0,0,85,0,-85
6026,0,0,20,0,-20
6027,1,0,8,0,-8
6028,0,0,31,0,-31
6029,1,1,116,1333,1217
6030,0,0,21,0,-21
6031,0,0,188,0,-188
6032,1,0,38,0,-38
6033,0,0,74,0,-74
6034,1,0,0,0,0
6035,1,1,854,1284,430
6036,0,0,20,0,-20
6037,0,0,8,0,-8
6038,0,0,6,0,-6
6039,1,0,300,0,-300
6040,1,0,172,0,-172
6041,0,0,14,0,-14
6042,1,1,342,1541,1199
6043,1,0,148,0,-148
6044,0,0,32,0,-32
6045,0,0,21,0,-21
6046,0,0,84,0,-84
6047,0,0,11,0,-11
6048,0,0,37,0,-37
6049,1,1,558,1419,861
6050,0,0,38,0,-38
6051,0,0,32,0,-32
6052,1,1,56,1584,1528
6053,0,0,121,0,-121
6054,0,0,178,0,-178
6055,0,0,52,0,-52
6056,1,1,528,4025,3497
6057,0,0,27,0,-27
6058,1,1,38,1775,1737
6059,1,0,47,0,-47
6060,0,0,5,0,-5
6061,1,0,117,0,-117
6062,1,0,31,0,-31
6063,1,1,188,1760,1572
6064,1,0,20,0,-20
6065,1,0,3,0,-3
6066,1,1,371,1637,1266
6067,0,0,122,0,-122
6068,1,0,2,0,-2
6069,1,0,58,0,-58
6070,0,0,30,0,-30
6071,1,0,1,0,-1
6072,1,0,43,0,-43
6073,0,0,6,0,-6
6074,1,0,8,0,-8
6075,1,0,98,0,-98
6076,0,0,98,0,-98
6077,1,0,11,0,-11
6078,0,0,81,0,-81
6079,0,0,118,0,-118
6080,0,0,18,0,-18
6081,1,0,46,0,-46
6082,0,0,58,0,-58
6083,1,1,1019,1328,309
6084,1,1,1288,1588,300
6085,0,0,166,0,-166
6086,1,0,13,0,-13
6087,1,0,96,0,-96
6088,1,0,103,0,-103
6089,0,0,58,0,-58
6090,1,1,89,1322,1233
6091,1,1,237,1276,1039
6092,1,1,269,1383,1114
6093,1,1,1225,1485,260
6094,0,0,136,0,-136
6095,1,0,18,0,-18
6096,1,0,129,0,-129
6097,1,1,779,1336,557
6098,0,0,98,0,-98
6099,1,1,228,1649,1421
6100,1,1,132,1286,1154
6101,1,0,38,0,-38
6102,1,0,24,0,-24
6103,0,0,77,0,-77
6104,1,0,32,0,-32
6105,0,0,61,0,-61
6106,1,1,156,1529,1373
6107,0,0,23,0,-23
6108,1,1,490,1930,1440
6109,0,0,69,0,-69
6110,0,0,2,0,-2
6111,0,0,83,0,-83
6112,1,1,113,1849,1736
6113,1,0,24,0,-24
6114,1,0,116,0,-116
6115,0,0,6,0,-6
6116,1,0,12,0,-12
6117,0,0,50,0,-50
6118,1,0,78,0,-78
6119,0,0,105,0,-105
6120,0,0,2,0,-2
6121,0,0,6,0,-6
6122,1,0,129,0,-129
6123,1,0,37,0,-37
6124,1,1,346,1650,1304
6125,0,0,11,0,-11
6126,1,1,1891,1270,-621
6127,1,1,147,1728,1581
6128,1,0,1,0,-1
6129,1,0,9,0,-9
6130,1,0,89,0,-89
6131,1,0,42,0,-42
6132,0,0,64,0,-64
6133,0,0,1,0,-1
6134,1,0,5,0,-5
6135,0,0,0,0,0
6136,1,1,1147,1241,94
6137,1,1,325,1247,922
6138,1,1,215,3183,2968
6139,0,0,11,0,-11
6140,1,1,174,1625,1451
6141,1,0,166,0,-166
6142,0,0,44,0,-44
6143,1,1,336,2031,1695
6144,0,0,58,0,-58
6145,1,1,390,1498,1108
6146,1,0,28,0,-28
6147,1,1,1011,1251,240
6148,0,0,19,0,-19
6149,1,0,42,0,-42
6150,1,1,747,1892,1145
6151,0,0,91,0,-91
6152,1,0,0,0,0
6153,0,0,29,0,-29
6154,1,1,477,1326,849
6155,0,0,58,0,-58
6156,1,1,845,1408,563
6157,1,0,8,0,-8
6158,1,1,354,1502,1148
6159,1,0,85,0,-85
6160,1,0,91,0,-91
6161,1,1,551,2260,1709
6162,1,1,519,1288,769
6163,0,0,22,0,-22
6164,1,0,23,0,-23
6165,1,1,254,1325,1071
6166,0,0,38,0,-38
6167,0,0,8,0,-8
6168,1,0,254,0,-254
6169,0,0,44,0,-44
6170,0,0,254,0,-254
6171,1,0,23,0,-23
6172,1,1,262,1255,993
6173,1,0,106,0,-106
6174,0,0,48,0,-48
6175,1,0,32,0,-32
6176,0,0,12,0,-12
6177,1,1,917,3584,2667
6178,1,0,92,0,-92
6179,1,0,24,0,-24
6180,0,0,27,0,-27
6181,0,0,10,0,-10
6182,0,0,34,0,-34
6183,1,0,13,0,-13
6184,0,0,25,0,-25
6185,0,0,6,0,-6
6186,1,1,160,1415,1255
6187,0,0,74,0,-74
6188,1,1,1716,1306,-410
6189,1,0,45,0,-45
6190,1,0,161,0,-161
6191,1,0,39,0,-39
6192,0,0,0,0,0
6193,1,0,8,0,-8
6194,0,0,42,0,-42
6195,1,0,9,0,-9
6196,1,0,57,0,-57
6197,0,0,0,0,0
6198,1,0,8,0,-8
6199,1,0,33,0,-33
6200,1,0,20,0,-20
6201,1,0,35,0,-35
6202,1,0,61,0,-61
6203,1,0,32,0,-32
6204,0,0,14,0,-14
6205,1,0,7,0,-7
6206,0,0,44,0,-44
6207,0,0,5,0,-5
6208,1,1,113,1400,1287
6209,1,0,18,0,-18
6210,1,1,697,2022,1325
6211,0,0,2,0,-2
6212,1,0,83,0,-83
6213,1,0,89,0,-89
6214,0,0,1,0,-1
6215,0,0,59,0,-59
6216,0,0,6,0,-6
6217,1,0,82,0,-82
6218,1,1,498,1253,755
6219,0,0,72,0,-72
6220,0,0,136,0,-136
6221,1,1,250,1346,1096
6222,1,0,55,0,-55
6223,1,0,39,0,-39
6224,0,0,39,0,-39
6225,1,1,153,1239,1086
6226,1,0,64,0,-64
6227,0,0,19,0,-19
6228,0,0,59,0,-59
6229,1,1,428,1294,866
6230,0,0,50,0,-50
6231,1,0,21,0,-21
6232,1,1,275,1739,1464
6233,1,0,25,0,-25
6234,1,0,40,0,-40
6235,1,1,138,1751,1613
6236,0,0,220,0,-220
6237,1,0,11,0,-11
6238,1,0,8,0,-8
6239,1,0,60,0,-60
6240,0,0,17,0,-17
6241,1,1,1173,1751,578
6242,1,0,51,0,-51
6243,1,1,1316,2716,1400
6244,1,1,401,3551,3150
6245,0,0,28,0,-28
6246,0,0,21,0,-21
6247,0,0,16,0,-16
6248,0,0,80,0,-80
6249,1,1,1542,1477,-65
6250,1,0,41,0,-41
6251,0,0,4,0,-4
6252,1,0,95,0,-95
6253,1,0,23,0,-23
6254,1,1,917,1278,361
6255,1,0,31,0,-31
6256,1,0,161,0,-161
6257,0,0,43,0,-43
6258,1,0,5,0,-5
6259,1,1,793,1344,551
6260,1,1,150,1363,1213
6261,0,0,109,0,-109
6262,1,1,290,1291,1001
6263,0,0,31,0,-31
6264,1,1,98,1622,1524
6265,1,1,510,2045,1535
6266,1,0,6,0,-6
6267,0,0,112,0,-112
6268,1,0,32,0,-32
6269,0,0,17,0,-17
6270,1,1,503,1459,956
6271,1,1,663,1692,1029
6272,1,0,35,0,-35
6273,0,0,11,0,-11
6274,0,0,176,0,-176
6275,1,1,154,1290,1136
6276,0,0,78,0,-78
6277,1,0,4,0,-4
6278,1,0,47,0,-47
6279,0,0,6,0,-6
6280,1,1,134,1328,1194
